../DataSets\DelayGraph_0.graphml,91,106,197,0.0,126
../DataSets\DelayGraph_1.graphml,91,106,197,0.0,126
../DataSets\DelayGraph_2.graphml,120,134,254,0.0,130
../DataSets\DelayGraph_3.graphml,868,1048,1916,0.0,3395509206
../DataSets\DelayGraph_4.graphml,118,138,256,0.0,152
../DataSets\DelayGraph_5.graphml,483,579,1062,0.0,439149
../DataSets\DelayGraph_6.graphml,275,327,602,0.0010001659393310547,179026
../DataSets\DelayGraph_7.graphml,867,1123,1990,0.002499818801879883,39994352409384863
../DataSets\DelayGraph_8.graphml,867,1123,1990,0.0,39994352409384863
../DataSets\DelayGraph_9.graphml,61,69,130,0.0,12
../DataSets\DelayGraph_10.graphml,644,849,1493,0.0,250698831527
../DataSets\DelayGraph_11.graphml,426,517,943,0.0,348245
../DataSets\DelayGraph_12.graphml,644,849,1493,0.0025000572204589844,250698831527
../DataSets\DelayGraph_13.graphml,218,261,479,0.0,1158
../DataSets\DelayGraph_14.graphml,638,795,1433,0.0,28911492566
../DataSets\DelayGraph_15.graphml,120,134,254,0.0,130
../DataSets\DelayGraph_16.graphml,83,86,169,0.0,28
../DataSets\DelayGraph_17.graphml,816,1034,1850,0.0025000572204589844,274309687306608
../DataSets\DelayGraph_18.graphml,145,167,312,0.0,275
../DataSets\DelayGraph_19.graphml,145,167,312,0.0,275
../DataSets\DelayGraph_20.graphml,212,250,462,0.0,196
../DataSets\DelayGraph_21.graphml,834,1050,1884,0.002499818801879883,12694168275610
../DataSets\DelayGraph_22.graphml,376,446,822,0.0,4142
../DataSets\DelayGraph_23.graphml,212,250,462,0.0,196
../DataSets\DelayGraph_24.graphml,731,864,1595,0.0025000572204589844,1319346
../DataSets\DelayGraph_25.graphml,128,150,278,0.0,51
../DataSets\DelayGraph_26.graphml,855,1054,1909,0.0025000572204589844,93513162062
../DataSets\DelayGraph_27.graphml,83,86,169,0.0,28
../DataSets\DelayGraph_28.graphml,6870,8722,15592,0.02500009536743164,516
../DataSets\DelayGraph_29.graphml,1587,2063,3650,0.005000114440917969,161
../DataSets\DelayGraph_30.graphml,5695,7224,12919,0.017499923706054688,5341
../DataSets\DelayGraph_31.graphml,2419,3108,5527,0.004999876022338867,1357
../DataSets\DelayGraph_32.graphml,1401,1862,3263,0.0025000572204589844,506
../DataSets\DelayGraph_33.graphml,13459,16912,30371,0.03250002861022949,10188
../DataSets\DelayGraph_34.graphml,13459,16912,30371,0.034999847412109375,10188
../DataSets\DelayGraph_35.graphml,8,6,14,0.0,2
../DataSets\DelayGraph_36.graphml,8,6,14,0.0,2
../DataSets\DelayGraph_37.graphml,8,6,14,0.0,2
../DataSets\DelayGraph_38.graphml,8,6,14,0.0,2
../DataSets\DelayGraph_39.graphml,8,6,14,0.0,2
../DataSets\DelayGraph_40.graphml,8,6,14,0.0,2
../DataSets\DelayGraph_41.graphml,8,6,14,0.0,2
../DataSets\DelayGraph_42.graphml,8,6,14,0.0,2
../DataSets\DelayGraph_43.graphml,8,6,14,0.0,2
../DataSets\DelayGraph_44.graphml,8,6,14,0.0,2
../DataSets\DelayGraph_45.graphml,8,6,14,0.0,2
../DataSets\DelayGraph_46.graphml,8,6,14,0.0,2
../DataSets\DelayGraph_47.graphml,8,6,14,0.0,2
../DataSets\DelayGraph_48.graphml,8,6,14,0.0,2
../DataSets\DelayGraph_49.graphml,8,6,14,0.0,2
../DataSets\DelayGraph_50.graphml,8,6,14,0.0,2
../DataSets\DelayGraph_51.graphml,8,6,14,0.0,2
../DataSets\DelayGraph_52.graphml,8,6,14,0.0,2
../DataSets\DelayGraph_53.graphml,8,6,14,0.0,2
../DataSets\DelayGraph_54.graphml,8,6,14,0.0,2
../DataSets\DelayGraph_55.graphml,8,6,14,0.0,2
../DataSets\DelayGraph_56.graphml,8,6,14,0.0,2
../DataSets\DelayGraph_57.graphml,8,6,14,0.0,2
../DataSets\DelayGraph_58.graphml,8,6,14,0.0,2
../DataSets\DelayGraph_59.graphml,8,6,14,0.0,2
../DataSets\DelayGraph_60.graphml,8,6,14,0.0,2
../DataSets\DelayGraph_61.graphml,8,6,14,0.0,2
../DataSets\DelayGraph_62.graphml,8,6,14,0.0,2
../DataSets\DelayGraph_63.graphml,8,6,14,0.0,2
../DataSets\DelayGraph_64.graphml,8,6,14,0.0,2
../DataSets\DelayGraph_65.graphml,8,6,14,0.0,2
../DataSets\DelayGraph_66.graphml,8,6,14,0.0,2
../DataSets\DelayGraph_67.graphml,8,6,14,0.0,2
../DataSets\DelayGraph_68.graphml,8,6,14,0.0,2
../DataSets\DelayGraph_69.graphml,8,6,14,0.0,2
../DataSets\DelayGraph_70.graphml,8,6,14,0.0,2
../DataSets\DelayGraph_71.graphml,8,6,14,0.0,2
../DataSets\DelayGraph_72.graphml,8,6,14,0.0,2
../DataSets\DelayGraph_73.graphml,8,6,14,0.0,2
../DataSets\DelayGraph_74.graphml,8,6,14,0.0,2
../DataSets\DelayGraph_75.graphml,8,6,14,0.0,2
../DataSets\DelayGraph_76.graphml,8,6,14,0.0,2
../DataSets\DelayGraph_77.graphml,8,6,14,0.0,2
../DataSets\DelayGraph_78.graphml,8,6,14,0.0,2
../DataSets\DelayGraph_79.graphml,302,353,655,0.0025000572204589844,751
../DataSets\DelayGraph_80.graphml,302,353,655,0.0025000572204589844,751
../DataSets\DelayGraph_81.graphml,212,250,462,0.0,734
../DataSets\DelayGraph_82.graphml,212,250,462,0.0,734
../DataSets\DelayGraph_83.graphml,120,134,254,0.0,130
../DataSets\DelayGraph_84.graphml,483,579,1062,0.002499818801879883,784043
../DataSets\DelayGraph_85.graphml,275,327,602,0.0,6025
../DataSets\DelayGraph_86.graphml,118,138,256,0.0,151
../DataSets\DelayGraph_87.graphml,171,201,372,0.0025000572204589844,534
../DataSets\DelayGraph_88.graphml,867,1123,1990,0.002499818801879883,39994352409384863
../DataSets\DelayGraph_89.graphml,867,1123,1990,0.0025000572204589844,39994352409384863
../DataSets\DelayGraph_90.graphml,868,1048,1916,0.0025000572204589844,3649386730
../DataSets\DelayGraph_91.graphml,644,849,1493,0.002000093460083008,250698831527
../DataSets\DelayGraph_92.graphml,644,849,1493,0.0,250698831527
../DataSets\DelayGraph_93.graphml,113,133,246,0.0,81
../DataSets\DelayGraph_94.graphml,638,795,1433,0.0025000572204589844,18770597608
../DataSets\DelayGraph_95.graphml,218,261,479,0.0025000572204589844,1110
../DataSets\DelayGraph_96.graphml,426,517,943,0.0,504062
../DataSets\DelayGraph_97.graphml,61,69,130,0.0,13
../DataSets\DelayGraph_98.graphml,120,134,254,0.0,130
../DataSets\DelayGraph_99.graphml,111,125,236,0.0,130
../DataSets\DelayGraph_100.graphml,867,1123,1990,0.0025000572204589844,39994352409384863
../DataSets\DelayGraph_101.graphml,275,327,602,0.0,5983
../DataSets\DelayGraph_102.graphml,867,1123,1990,0.002000093460083008,39994352409384863
../DataSets\DelayGraph_103.graphml,118,138,256,0.0,152
../DataSets\DelayGraph_104.graphml,483,579,1062,0.0010001659393310547,436155
../DataSets\DelayGraph_105.graphml,868,1048,1916,0.0,3311856501
../DataSets\DelayGraph_106.graphml,426,517,943,0.0,300276
../DataSets\DelayGraph_107.graphml,218,261,479,0.0,1405
../DataSets\DelayGraph_108.graphml,644,849,1493,0.0,250698831527
../DataSets\DelayGraph_109.graphml,61,69,130,0.0,13
../DataSets\DelayGraph_110.graphml,638,795,1433,0.0,25093743874
../DataSets\DelayGraph_111.graphml,644,849,1493,0.0025000572204589844,250698831527
../DataSets\DelayGraph_112.graphml,111,125,236,0.0,130
../DataSets\DelayGraph_113.graphml,1873,2422,4295,0.004999876022338867,693
../DataSets\DelayGraph_114.graphml,6798,8786,15584,0.02500009536743164,772
../DataSets\DelayGraph_115.graphml,5947,7446,13393,0.019999980926513672,5341
../DataSets\DelayGraph_116.graphml,1403,1864,3267,0.0025000572204589844,506
../DataSets\DelayGraph_117.graphml,26393,33302,59695,0.15000009536743164,310168
../DataSets\DelayGraph_118.graphml,26393,33302,59695,0.1634998321533203,310168
../DataSets\DelayGraph_119.graphml,8,6,14,0.0025000572204589844,2
../DataSets\DelayGraph_120.graphml,8,6,14,0.0,2
../DataSets\DelayGraph_121.graphml,8,6,14,0.0,2
../DataSets\DelayGraph_122.graphml,8,6,14,0.0,2
../DataSets\DelayGraph_123.graphml,8,6,14,0.0,2
../DataSets\DelayGraph_124.graphml,8,6,14,0.0,2
../DataSets\DelayGraph_125.graphml,8,6,14,0.0,2
../DataSets\DelayGraph_126.graphml,8,6,14,0.0,2
../DataSets\DelayGraph_127.graphml,8,6,14,0.0,2
../DataSets\DelayGraph_128.graphml,8,6,14,0.0,2
../DataSets\DelayGraph_129.graphml,8,6,14,0.0,2
../DataSets\DelayGraph_130.graphml,8,6,14,0.0,2
../DataSets\DelayGraph_131.graphml,8,6,14,0.0,2
../DataSets\DelayGraph_132.graphml,8,6,14,0.0,2
../DataSets\DelayGraph_133.graphml,8,6,14,0.0,2
../DataSets\DelayGraph_134.graphml,8,6,14,0.0,2
../DataSets\DelayGraph_135.graphml,8,6,14,0.0,2
../DataSets\DelayGraph_136.graphml,8,6,14,0.0,2
../DataSets\DelayGraph_137.graphml,8,6,14,0.0,2
../DataSets\DelayGraph_138.graphml,8,6,14,0.0,2
../DataSets\DelayGraph_139.graphml,8,6,14,0.0,2
../DataSets\DelayGraph_140.graphml,8,6,14,0.0025000572204589844,2
../DataSets\DelayGraph_141.graphml,8,6,14,0.0,2
../DataSets\DelayGraph_142.graphml,8,6,14,0.0,2
../DataSets\DelayGraph_143.graphml,8,6,14,0.0,2
../DataSets\DelayGraph_144.graphml,8,6,14,0.0,2
../DataSets\DelayGraph_145.graphml,8,6,14,0.0,2
../DataSets\DelayGraph_146.graphml,8,6,14,0.0,2
../DataSets\DelayGraph_147.graphml,8,6,14,0.0,2
../DataSets\DelayGraph_148.graphml,8,6,14,0.0,2
../DataSets\DelayGraph_149.graphml,8,6,14,0.0,2
../DataSets\DelayGraph_150.graphml,8,6,14,0.0,2
../DataSets\DelayGraph_151.graphml,8,6,14,0.0,2
../DataSets\DelayGraph_152.graphml,8,6,14,0.0,2
../DataSets\DelayGraph_153.graphml,8,6,14,0.0,2
../DataSets\DelayGraph_154.graphml,8,6,14,0.0,2
../DataSets\DelayGraph_155.graphml,8,6,14,0.0,2
../DataSets\DelayGraph_156.graphml,8,6,14,0.0,2
../DataSets\DelayGraph_157.graphml,8,6,14,0.0,2
../DataSets\DelayGraph_158.graphml,8,6,14,0.0,2
../DataSets\DelayGraph_159.graphml,8,6,14,0.0,2
../DataSets\DelayGraph_160.graphml,8,6,14,0.0,2
../DataSets\DelayGraph_161.graphml,8,6,14,0.0,2
../DataSets\DelayGraph_162.graphml,8,6,14,0.0,2
../DataSets\DelayGraph_163.graphml,8,6,14,0.0,2
../DataSets\DelayGraph_164.graphml,8,6,14,0.0,2
../DataSets\DelayGraph_165.graphml,8,6,14,0.0,2
../DataSets\DelayGraph_166.graphml,8,6,14,0.0,2
../DataSets\DelayGraph_167.graphml,8,6,14,0.0,2
../DataSets\DelayGraph_168.graphml,8,6,14,0.0,2
../DataSets\DelayGraph_169.graphml,302,353,655,0.0025000572204589844,751
../DataSets\DelayGraph_170.graphml,302,353,655,0.0,751
../DataSets\DelayGraph_171.graphml,48,51,99,0.0,28
../DataSets\DelayGraph_172.graphml,816,1034,1850,0.0,274309687306608
../DataSets\DelayGraph_173.graphml,816,1034,1850,0.0025000572204589844,274309687306608
../DataSets\DelayGraph_174.graphml,145,167,312,0.0,389
../DataSets\DelayGraph_175.graphml,802,964,1766,0.0025000572204589844,5484107135
../DataSets\DelayGraph_176.graphml,833,1049,1882,0.0,12694168275610
../DataSets\DelayGraph_177.graphml,121,143,264,0.0009999275207519531,51
../DataSets\DelayGraph_178.graphml,833,1049,1882,0.0025000572204589844,12694168275610
../DataSets\DelayGraph_179.graphml,848,1047,1895,0.0,93513162062
../DataSets\DelayGraph_180.graphml,48,51,99,0.0,28
../DataSets\DelayGraph_181.graphml,1612,2088,3700,0.002499818801879883,161
../DataSets\DelayGraph_182.graphml,1901,2448,4349,0.005000114440917969,693
../DataSets\DelayGraph_183.graphml,7306,9232,16538,0.019999980926513672,772
../DataSets\DelayGraph_184.graphml,2479,3162,5641,0.005000114440917969,1357
../DataSets\DelayGraph_185.graphml,3635,4590,8225,0.009999990463256836,2685
../DataSets\DelayGraph_186.graphml,1403,1864,3267,0.0025000572204589844,506
../DataSets\DelayGraph_187.graphml,6827,8692,15519,0.01750016212463379,777
../DataSets\DelayGraph_188.graphml,78129,98862,176991,0.6474997997283936,23610520904
../DataSets\DelayGraph_189.graphml,78129,98862,176991,0.9470000267028809,23610520904
../DataSets\DelayGraph_190.graphml,8,6,14,0.0025000572204589844,2
../DataSets\DelayGraph_191.graphml,8,6,14,0.0,2
../DataSets\DelayGraph_192.graphml,8,6,14,0.0,2
../DataSets\DelayGraph_193.graphml,8,6,14,0.0,2
../DataSets\DelayGraph_194.graphml,8,6,14,0.0,2
../DataSets\DelayGraph_195.graphml,8,6,14,0.0,2
../DataSets\DelayGraph_196.graphml,8,6,14,0.0,2
../DataSets\DelayGraph_197.graphml,8,6,14,0.0,2
../DataSets\DelayGraph_198.graphml,8,6,14,0.0,2
../DataSets\DelayGraph_199.graphml,8,6,14,0.0,2
../DataSets\DelayGraph_200.graphml,8,6,14,0.0,2
../DataSets\DelayGraph_201.graphml,8,6,14,0.0,2
../DataSets\DelayGraph_202.graphml,8,6,14,0.0,2
../DataSets\DelayGraph_203.graphml,8,6,14,0.0,2
../DataSets\DelayGraph_204.graphml,8,6,14,0.0,2
../DataSets\DelayGraph_205.graphml,8,6,14,0.0,2
../DataSets\DelayGraph_206.graphml,8,6,14,0.0,2
../DataSets\DelayGraph_207.graphml,8,6,14,0.0,2
../DataSets\DelayGraph_208.graphml,8,6,14,0.0,2
../DataSets\DelayGraph_209.graphml,8,6,14,0.0,2
../DataSets\DelayGraph_210.graphml,8,6,14,0.0,2
../DataSets\DelayGraph_211.graphml,8,6,14,0.0,2
../DataSets\DelayGraph_212.graphml,8,6,14,0.0,2
../DataSets\DelayGraph_213.graphml,8,6,14,0.0,2
../DataSets\DelayGraph_214.graphml,8,6,14,0.0,2
../DataSets\DelayGraph_215.graphml,8,6,14,0.0,2
../DataSets\DelayGraph_216.graphml,8,6,14,0.0,2
../DataSets\DelayGraph_217.graphml,8,6,14,0.0,2
../DataSets\DelayGraph_218.graphml,8,6,14,0.0,2
../DataSets\DelayGraph_219.graphml,8,6,14,0.0,2
../DataSets\DelayGraph_220.graphml,8,6,14,0.0,2
../DataSets\DelayGraph_221.graphml,8,6,14,0.0,2
../DataSets\DelayGraph_222.graphml,8,6,14,0.0,2
../DataSets\DelayGraph_223.graphml,8,6,14,0.0,2
../DataSets\DelayGraph_224.graphml,8,6,14,0.0,2
../DataSets\DelayGraph_225.graphml,8,6,14,0.0,2
../DataSets\DelayGraph_226.graphml,8,6,14,0.0,2
../DataSets\DelayGraph_227.graphml,8,6,14,0.0,2
../DataSets\DelayGraph_228.graphml,8,6,14,0.0,2
../DataSets\DelayGraph_229.graphml,8,6,14,0.0,2
../DataSets\DelayGraph_230.graphml,8,6,14,0.0,2
../DataSets\DelayGraph_231.graphml,8,6,14,0.0,2
../DataSets\DelayGraph_232.graphml,8,6,14,0.0,2
../DataSets\DelayGraph_233.graphml,8,6,14,0.0,2
../DataSets\DelayGraph_234.graphml,8,6,14,0.0,2
../DataSets\DelayGraph_235.graphml,8,6,14,0.0,2
../DataSets\DelayGraph_236.graphml,8,6,14,0.0,2
../DataSets\DelayGraph_237.graphml,8,6,14,0.0,2
../DataSets\DelayGraph_238.graphml,8,6,14,0.0,2
../DataSets\DelayGraph_239.graphml,131,141,272,0.0,40
../DataSets\DelayGraph_240.graphml,131,141,272,0.0,40
../DataSets\DelayGraph_241.graphml,90,105,195,0.0,126
../DataSets\DelayGraph_242.graphml,90,105,195,0.0,126
../DataSets\DelayGraph_243.graphml,111,125,236,0.0,130
../DataSets\DelayGraph_244.graphml,867,1123,1990,0.0009999275207519531,39994352409384863
../DataSets\DelayGraph_245.graphml,867,1123,1990,0.002499818801879883,39994352409384863
../DataSets\DelayGraph_246.graphml,171,201,372,0.0,624
../DataSets\DelayGraph_247.graphml,483,579,1062,0.0009999275207519531,438539
../DataSets\DelayGraph_248.graphml,868,1048,1916,0.0025000572204589844,4218988954
../DataSets\DelayGraph_249.graphml,275,327,602,0.0,5813
../DataSets\DelayGraph_250.graphml,118,138,256,0.0,151
../DataSets\DelayGraph_251.graphml,638,795,1433,0.0025000572204589844,21156690516
../DataSets\DelayGraph_252.graphml,113,133,246,0.0,67
../DataSets\DelayGraph_253.graphml,644,849,1493,0.0025000572204589844,250698831527
../DataSets\DelayGraph_254.graphml,218,261,479,0.0,1266
../DataSets\DelayGraph_255.graphml,644,849,1493,0.0,250698831527
../DataSets\DelayGraph_256.graphml,426,517,943,0.002499818801879883,312320
../DataSets\DelayGraph_257.graphml,61,69,130,0.0,12
../DataSets\DelayGraph_258.graphml,111,125,236,0.0,130
../DataSets\DelayGraph_259.graphml,175,202,377,0.0,3608
../DataSets\DelayGraph_260.graphml,175,202,377,0.0025000572204589844,3608
../DataSets\DelayGraph_261.graphml,83,86,169,0.0,28
../DataSets\DelayGraph_262.graphml,816,1034,1850,0.0025000572204589844,274309687306608
../DataSets\DelayGraph_263.graphml,145,167,312,0.0025000572204589844,358
../DataSets\DelayGraph_264.graphml,802,964,1766,0.0,4656109011
../DataSets\DelayGraph_265.graphml,816,1034,1850,0.0025000572204589844,274309687306608
../DataSets\DelayGraph_266.graphml,834,1050,1884,0.0025000572204589844,12694168275610
../DataSets\DelayGraph_267.graphml,834,1050,1884,0.0025000572204589844,12694168275610
../DataSets\DelayGraph_268.graphml,128,150,278,0.0,51
../DataSets\DelayGraph_269.graphml,855,1054,1909,0.0,93513162062
../DataSets\DelayGraph_270.graphml,83,86,169,0.0,28
../DataSets\DelayGraph_271.graphml,48,51,99,0.0,28
../DataSets\DelayGraph_272.graphml,145,167,312,0.002499818801879883,275
../DataSets\DelayGraph_273.graphml,816,1034,1850,0.0025000572204589844,274309687306608
../DataSets\DelayGraph_274.graphml,145,167,312,0.0,278
../DataSets\DelayGraph_275.graphml,121,143,264,0.0,51
../DataSets\DelayGraph_276.graphml,121,143,264,0.0,51
../DataSets\DelayGraph_277.graphml,833,1049,1882,0.0,12694168275610
../DataSets\DelayGraph_278.graphml,48,51,99,0.0,28
../DataSets\DelayGraph_279.graphml,3511,4480,7991,0.007500171661376953,2685
../DataSets\DelayGraph_280.graphml,1403,1864,3267,0.0025000572204589844,506
../DataSets\DelayGraph_281.graphml,52261,66082,118343,0.24900007247924805,91505136
../DataSets\DelayGraph_282.graphml,52261,66082,118343,0.18249988555908203,91505136
../DataSets\DelayGraph_283.graphml,8,6,14,0.002499818801879883,2
../DataSets\DelayGraph_284.graphml,8,6,14,0.0,2
../DataSets\DelayGraph_285.graphml,8,6,14,0.0,2
../DataSets\DelayGraph_286.graphml,8,6,14,0.0,2
../DataSets\DelayGraph_287.graphml,8,6,14,0.0,2
../DataSets\DelayGraph_288.graphml,8,6,14,0.0,2
../DataSets\DelayGraph_289.graphml,8,6,14,0.0,2
../DataSets\DelayGraph_290.graphml,8,6,14,0.0,2
../DataSets\DelayGraph_291.graphml,8,6,14,0.0,2
../DataSets\DelayGraph_292.graphml,8,6,14,0.0,2
../DataSets\DelayGraph_293.graphml,8,6,14,0.0,2
../DataSets\DelayGraph_294.graphml,8,6,14,0.0,2
../DataSets\DelayGraph_295.graphml,8,6,14,0.0,2
../DataSets\DelayGraph_296.graphml,8,6,14,0.0,2
../DataSets\DelayGraph_297.graphml,8,6,14,0.0,2
../DataSets\DelayGraph_298.graphml,8,6,14,0.0,2
../DataSets\DelayGraph_299.graphml,8,6,14,0.0,2
../DataSets\DelayGraph_300.graphml,8,6,14,0.0,2
../DataSets\DelayGraph_301.graphml,8,6,14,0.0,2
../DataSets\DelayGraph_302.graphml,8,6,14,0.0,2
../DataSets\DelayGraph_303.graphml,8,6,14,0.0,2
../DataSets\DelayGraph_304.graphml,8,6,14,0.0,2
../DataSets\DelayGraph_305.graphml,8,6,14,0.0,2
../DataSets\DelayGraph_306.graphml,8,6,14,0.0,2
../DataSets\DelayGraph_307.graphml,8,6,14,0.0,2
../DataSets\DelayGraph_308.graphml,8,6,14,0.0,2
../DataSets\DelayGraph_309.graphml,8,6,14,0.0,2
../DataSets\DelayGraph_310.graphml,8,6,14,0.0,2
../DataSets\DelayGraph_311.graphml,8,6,14,0.0,2
../DataSets\DelayGraph_312.graphml,8,6,14,0.0,2
../DataSets\DelayGraph_313.graphml,8,6,14,0.0,2
../DataSets\DelayGraph_314.graphml,8,6,14,0.0,2
../DataSets\DelayGraph_315.graphml,8,6,14,0.0,2
../DataSets\DelayGraph_316.graphml,8,6,14,0.0,2
../DataSets\DelayGraph_317.graphml,8,6,14,0.0,2
../DataSets\DelayGraph_318.graphml,8,6,14,0.0,2
../DataSets\DelayGraph_319.graphml,8,6,14,0.0,2
../DataSets\DelayGraph_320.graphml,8,6,14,0.0,2
../DataSets\DelayGraph_321.graphml,8,6,14,0.0,2
../DataSets\DelayGraph_322.graphml,8,6,14,0.0,2
../DataSets\DelayGraph_323.graphml,8,6,14,0.0,2
../DataSets\DelayGraph_324.graphml,8,6,14,0.0,2
../DataSets\DelayGraph_325.graphml,8,6,14,0.0,2
../DataSets\DelayGraph_326.graphml,8,6,14,0.0,2
../DataSets\DelayGraph_327.graphml,8,6,14,0.0,2
../DataSets\DelayGraph_328.graphml,8,6,14,0.0,2
../DataSets\DelayGraph_329.graphml,8,6,14,0.0,2
../DataSets\DelayGraph_330.graphml,8,6,14,0.0,2
../DataSets\DelayGraph_331.graphml,8,6,14,0.0,2
../DataSets\DelayGraph_332.graphml,203,241,444,0.0,702
../DataSets\DelayGraph_333.graphml,203,241,444,0.0009999275207519531,702
../DataSets\DelayGraph_334.graphml,175,202,377,0.0,3608
../DataSets\DelayGraph_335.graphml,175,202,377,0.0,3608
../DataSets\DelayGraph_336.graphml,8,6,14,0.0,2
../DataSets\DelayGraph_337.graphml,6,4,10,0.0,2
../DataSets\DelayGraph_338.graphml,6,4,10,0.0,2
../DataSets\DelayGraph_339.graphml,23,22,45,0.0,2
../DataSets\DelayGraph_340.graphml,23,22,45,0.0,2
../DataSets\DelayGraph_341.graphml,44,43,87,0.0,9
../DataSets\DelayGraph_342.graphml,44,43,87,0.0,9
../DataSets\DelayGraph_343.graphml,180,210,390,0.0,124
../DataSets\DelayGraph_344.graphml,180,210,390,0.0,124
../DataSets\DelayGraph_345.graphml,89,94,183,0.0,34
../DataSets\DelayGraph_346.graphml,89,94,183,0.0,34
../DataSets\DelayGraph_347.graphml,487,532,1019,0.0,864
../DataSets\DelayGraph_348.graphml,487,532,1019,0.0,864
../DataSets\DelayGraph_349.graphml,1356,1789,3145,0.0025000572204589844,285
../DataSets\DelayGraph_350.graphml,1356,1789,3145,0.0025000572204589844,285
../DataSets\DelayGraph_351.graphml,141,143,284,0.0,19
../DataSets\DelayGraph_352.graphml,141,143,284,0.0010001659393310547,19
../DataSets\DelayGraph_353.graphml,3876,5556,9432,0.0074999332427978516,4734
../DataSets\DelayGraph_354.graphml,3876,5556,9432,0.010000228881835938,4734
../DataSets\DelayGraph_355.graphml,41,44,85,0.0009999275207519531,8
../DataSets\DelayGraph_356.graphml,41,44,85,0.0,8
../DataSets\DelayGraph_357.graphml,23,22,45,0.0,2
../DataSets\DelayGraph_358.graphml,23,22,45,0.0,2
../DataSets\DelayGraph_359.graphml,155,174,329,0.0010001659393310547,39
../DataSets\DelayGraph_360.graphml,155,174,329,0.0,39
../DataSets\DelayGraph_361.graphml,1340,1723,3063,0.0025000572204589844,146
../DataSets\DelayGraph_362.graphml,1340,1723,3063,0.0025000572204589844,146
../DataSets\DelayGraph_363.graphml,88,94,182,0.0025000572204589844,24
../DataSets\DelayGraph_364.graphml,88,94,182,0.0,24
../DataSets\DelayGraph_365.graphml,98,101,199,0.0,11
../DataSets\DelayGraph_366.graphml,98,101,199,0.0,11
../DataSets\DelayGraph_367.graphml,8,7,15,0.0,2
../DataSets\DelayGraph_368.graphml,88,94,182,0.0,24
../DataSets\DelayGraph_369.graphml,190,231,421,0.0,9
../DataSets\DelayGraph_370.graphml,145,154,299,0.0025000572204589844,7
../DataSets\DelayGraph_371.graphml,145,154,299,0.0,7
../DataSets\DelayGraph_372.graphml,46,44,90,0.0025000572204589844,6
../DataSets\DelayGraph_373.graphml,7134,8326,15460,0.022500038146972656,9148
../DataSets\DelayGraph_374.graphml,62,63,125,0.0,13
../DataSets\DelayGraph_375.graphml,67,70,137,0.0,24
../DataSets\DelayGraph_376.graphml,43,53,96,0.0,24
../DataSets\DelayGraph_377.graphml,74,94,168,0.0025000572204589844,62
../DataSets\DelayGraph_378.graphml,74,94,168,0.0,62
../DataSets\DelayGraph_379.graphml,86,87,173,0.0,12
../DataSets\DelayGraph_380.graphml,86,87,173,0.0,12
../DataSets\DelayGraph_381.graphml,86,87,173,0.0,12
../DataSets\DelayGraph_382.graphml,126,135,261,0.0,32
../DataSets\DelayGraph_383.graphml,126,135,261,0.0,32
../DataSets\DelayGraph_384.graphml,90,90,180,0.0,18
../DataSets\DelayGraph_385.graphml,198,222,420,0.0,60
../DataSets\DelayGraph_386.graphml,198,222,420,0.0,60
../DataSets\DelayGraph_387.graphml,87,87,174,0.0,21
../DataSets\DelayGraph_388.graphml,204,223,427,0.0,333
../DataSets\DelayGraph_389.graphml,204,223,427,0.0,333
../DataSets\DelayGraph_390.graphml,193,204,397,0.0,5
../DataSets\DelayGraph_391.graphml,238,250,488,0.0,4
../DataSets\DelayGraph_392.graphml,330,360,690,0.0,23
../DataSets\DelayGraph_393.graphml,392,416,808,0.0,25
../DataSets\DelayGraph_394.graphml,347,370,717,0.0025000572204589844,27
../DataSets\DelayGraph_395.graphml,285,314,599,0.0,25
../DataSets\DelayGraph_396.graphml,1762,2339,4101,0.005000114440917969,1156144297430375889328011717978
../DataSets\DelayGraph_397.graphml,63,71,134,0.0,13
../DataSets\DelayGraph_398.graphml,428,519,947,0.0,395924
../DataSets\DelayGraph_399.graphml,1458,1805,3263,0.005000114440917969,127505714543614646846
../DataSets\DelayGraph_400.graphml,220,263,483,0.0025000572204589844,1293
../DataSets\DelayGraph_401.graphml,844,1031,1875,0.0,27406540210
../DataSets\DelayGraph_402.graphml,428,519,947,0.002499818801879883,329021
../DataSets\DelayGraph_403.graphml,116,135,251,0.0,66
../DataSets\DelayGraph_404.graphml,1762,2339,4101,0.005000114440917969,1156144297430375889328011717978
../DataSets\DelayGraph_405.graphml,238,250,488,0.0,4
../DataSets\DelayGraph_406.graphml,6371,8351,14722,0.015000104904174805,89193
../DataSets\DelayGraph_407.graphml,4949,6059,11008,0.009999990463256836,116135
../DataSets\DelayGraph_408.graphml,18528,25465,43993,0.04999995231628418,1172439
../DataSets\DelayGraph_409.graphml,4949,6059,11008,0.014999866485595703,116458
../DataSets\DelayGraph_410.graphml,31,32,63,0.0,5
../DataSets\DelayGraph_411.graphml,240,315,555,0.0025000572204589844,1896
../DataSets\DelayGraph_412.graphml,240,315,555,0.0009999275207519531,1896
../DataSets\DelayGraph_413.graphml,84,83,167,0.0009999275207519531,3
../DataSets\DelayGraph_414.graphml,84,83,167,0.0,3
../DataSets\DelayGraph_415.graphml,185,185,370,0.0,14
../DataSets\DelayGraph_416.graphml,185,185,370,0.002499818801879883,14
../DataSets\DelayGraph_417.graphml,192,201,393,0.0,40
../DataSets\DelayGraph_418.graphml,563,587,1150,0.0,137
../DataSets\DelayGraph_419.graphml,120,137,257,0.0025000572204589844,50
../DataSets\DelayGraph_420.graphml,120,137,257,0.0,50
../DataSets\DelayGraph_421.graphml,211,225,436,0.0,64
../DataSets\DelayGraph_422.graphml,215,280,495,0.0,190
../DataSets\DelayGraph_423.graphml,215,280,495,0.0,190
../DataSets\DelayGraph_424.graphml,311,329,640,0.0,80
../DataSets\DelayGraph_425.graphml,336,374,710,0.0,100
../DataSets\DelayGraph_426.graphml,336,374,710,0.0,100
../DataSets\DelayGraph_427.graphml,590,639,1229,0.0,168
../DataSets\DelayGraph_428.graphml,586,797,1383,0.0,420
../DataSets\DelayGraph_429.graphml,586,797,1383,0.002499818801879883,420
../DataSets\DelayGraph_430.graphml,124,122,246,0.0,8
../DataSets\DelayGraph_431.graphml,124,122,246,0.0025000572204589844,8
../DataSets\DelayGraph_432.graphml,1079,1338,2417,0.0025000572204589844,206377263934316031
../DataSets\DelayGraph_433.graphml,149,176,325,0.0,289
../DataSets\DelayGraph_434.graphml,1057,1368,2425,0.002499818801879883,48593138177403464450
../DataSets\DelayGraph_435.graphml,1057,1368,2425,0.0025000572204589844,48593138177403464450
../DataSets\DelayGraph_436.graphml,126,147,273,0.0,278
../DataSets\DelayGraph_437.graphml,618,795,1413,0.0,1128846449413
../DataSets\DelayGraph_438.graphml,624,765,1389,0.0,4804890596
../DataSets\DelayGraph_439.graphml,618,795,1413,0.0025000572204589844,1128846449413
../DataSets\DelayGraph_440.graphml,718,947,1665,0.0,4011181308413
../DataSets\DelayGraph_441.graphml,668,829,1497,0.0,20090405220
../DataSets\DelayGraph_442.graphml,718,947,1665,0.0,4011181308413
../DataSets\DelayGraph_443.graphml,63,71,134,0.0,2209203918472
../DataSets\DelayGraph_444.graphml,124,122,246,0.0,11
../DataSets\DelayGraph_445.graphml,438,476,914,0.0,131
../DataSets\DelayGraph_446.graphml,189,219,408,0.0,94
../DataSets\DelayGraph_447.graphml,192,210,402,0.0,66
../DataSets\DelayGraph_448.graphml,192,210,402,0.0,66
../DataSets\DelayGraph_449.graphml,35,36,71,0.0025000572204589844,3
../DataSets\DelayGraph_450.graphml,18,17,35,0.0,3
../DataSets\DelayGraph_451.graphml,78,80,158,0.0,14
../DataSets\DelayGraph_452.graphml,613,730,1343,0.0025000572204589844,233
../DataSets\DelayGraph_453.graphml,29107,46688,75795,0.06750011444091797,5491
../DataSets\DelayGraph_454.graphml,12080,14538,26618,0.05750012397766113,6228374260412089741198228294777869600346040470513792120326970294225954893196622065102
../DataSets\DelayGraph_455.graphml,12080,14538,26618,0.04499983787536621,6228374260412089741198228294777869600346040470513792120326970294225954893196622065102
../DataSets\DelayGraph_456.graphml,210,219,429,0.0025000572204589844,40
../DataSets\DelayGraph_457.graphml,1901,2448,4349,0.005000114440917969,693
../DataSets\DelayGraph_458.graphml,378,407,785,0.0025000572204589844,102
../DataSets\DelayGraph_459.graphml,193,192,385,0.0025000572204589844,45
../DataSets\DelayGraph_460.graphml,66,74,140,0.0,11
../DataSets\DelayGraph_461.graphml,66,74,140,0.0,11
../DataSets\DelayGraph_462.graphml,130,142,272,0.0,18
../DataSets\DelayGraph_463.graphml,92,99,191,0.0,9
../DataSets\DelayGraph_464.graphml,92,99,191,0.0,9
../DataSets\DelayGraph_465.graphml,2089,2797,4886,0.004999876022338867,3254
../DataSets\DelayGraph_466.graphml,54,59,113,0.0,34
../DataSets\DelayGraph_467.graphml,205,279,484,0.0,699
../DataSets\DelayGraph_468.graphml,205,279,484,0.0,699
../DataSets\DelayGraph_469.graphml,107,104,211,0.0,19
../DataSets\DelayGraph_470.graphml,107,104,211,0.0,19
../DataSets\DelayGraph_471.graphml,344,362,706,0.0,126
../DataSets\DelayGraph_472.graphml,5807,8443,14250,0.019999980926513672,36370
../DataSets\DelayGraph_473.graphml,5807,8443,14250,0.015000104904174805,36370
../DataSets\DelayGraph_474.graphml,708,863,1571,0.0025000572204589844,194847719128
../DataSets\DelayGraph_475.graphml,383,426,809,0.0,285
../DataSets\DelayGraph_476.graphml,1237,1483,2720,0.003000020980834961,83672062841
../DataSets\DelayGraph_477.graphml,1237,1483,2720,0.0025000572204589844,83672062841
../DataSets\DelayGraph_478.graphml,3695,4592,8287,0.009999990463256836,402718
../DataSets\DelayGraph_479.graphml,31,35,66,0.0,9
../DataSets\DelayGraph_480.graphml,278,303,581,0.0,91
../DataSets\DelayGraph_481.graphml,278,303,581,0.0,91
../DataSets\DelayGraph_482.graphml,33,33,66,0.0,8
../DataSets\DelayGraph_483.graphml,33,33,66,0.0,8
../DataSets\DelayGraph_484.graphml,92,90,182,0.0,15
../DataSets\DelayGraph_485.graphml,92,90,182,0.0,15
../DataSets\DelayGraph_486.graphml,324,381,705,0.0025000572204589844,5
../DataSets\DelayGraph_487.graphml,324,381,705,0.0,5
../DataSets\DelayGraph_488.graphml,6519,8743,15262,0.015000104904174805,10336
../DataSets\DelayGraph_489.graphml,15855,21498,37353,0.04999995231628418,230056815959598336472075889420114
../DataSets\DelayGraph_490.graphml,44012,110312,154324,0.1875,16560
../DataSets\DelayGraph_491.graphml,15855,21498,37353,0.057000160217285156,230056815959598336472075889420114
../DataSets\DelayGraph_492.graphml,17016,24790,41806,0.06699991226196289,223398
../DataSets\DelayGraph_493.graphml,1729,1845,3574,0.004999876022338867,1698
../DataSets\DelayGraph_494.graphml,4452,5196,9648,0.007500171661376953,807616170669868694672
../DataSets\DelayGraph_495.graphml,867,1123,1990,0.002499818801879883,39994352409384863
../DataSets\DelayGraph_496.graphml,117,137,254,0.0,173
../DataSets\DelayGraph_497.graphml,867,1123,1990,0.0025000572204589844,39994352409384863
../DataSets\DelayGraph_498.graphml,853,1033,1886,0.002499818801879883,3268862581
../DataSets\DelayGraph_499.graphml,790,1043,1833,0.0025000572204589844,64178900939427
../DataSets\DelayGraph_500.graphml,63,71,134,0.0,1466015503713
../DataSets\DelayGraph_501.graphml,696,861,1557,0.0025000572204589844,28915552608
../DataSets\DelayGraph_502.graphml,790,1043,1833,0.002499818801879883,64178900939427
../DataSets\DelayGraph_503.graphml,4452,5196,9648,0.009999990463256836,807616170669868694672
../DataSets\DelayGraph_504.graphml,35,34,69,0.0,8
../DataSets\DelayGraph_505.graphml,88,94,182,0.0,24
../DataSets\DelayGraph_506.graphml,131,145,276,0.0,33
../DataSets\DelayGraph_507.graphml,496,519,1015,0.0,557
../DataSets\DelayGraph_508.graphml,3580,6798,10378,0.007500171661376953,25646397314
../DataSets\DelayGraph_509.graphml,627,681,1308,0.0,600
../DataSets\DelayGraph_510.graphml,627,681,1308,0.0,597
../DataSets\DelayGraph_511.graphml,104,107,211,0.0,21
../DataSets\DelayGraph_512.graphml,730,868,1598,0.0025000572204589844,5368709121
../DataSets\DelayGraph_513.graphml,730,868,1598,0.0,5368709121
../DataSets\DelayGraph_514.graphml,319,347,666,0.0009999275207519531,69
../DataSets\DelayGraph_515.graphml,319,347,666,0.0,69
../DataSets\DelayGraph_516.graphml,156,166,322,0.0,35
../DataSets\DelayGraph_517.graphml,304,415,719,0.0010001659393310547,180
../DataSets\DelayGraph_518.graphml,304,415,719,0.0,180
../DataSets\DelayGraph_519.graphml,1016,1080,2096,0.0025000572204589844,336
../DataSets\DelayGraph_520.graphml,485,576,1061,0.0,200
../DataSets\DelayGraph_521.graphml,485,576,1061,0.0,200
../DataSets\DelayGraph_522.graphml,540,537,1077,0.0025000572204589844,187
../DataSets\DelayGraph_523.graphml,2172,6362,8534,0.0074999332427978516,6
../DataSets\DelayGraph_524.graphml,2172,6362,8534,0.004999876022338867,6
../DataSets\DelayGraph_525.graphml,525,632,1157,0.0,387
../DataSets\DelayGraph_526.graphml,5993,7226,13219,0.017499923706054688,10488241753700873040115096918848632668892482
../DataSets\DelayGraph_527.graphml,5993,7226,13219,0.022499799728393555,10488241753700873040115096918848632668892482
../DataSets\DelayGraph_528.graphml,19,18,37,0.0,4
../DataSets\DelayGraph_529.graphml,79,86,165,0.0,12
../DataSets\DelayGraph_530.graphml,355,407,762,0.0,1023
../DataSets\DelayGraph_531.graphml,381,442,823,0.0,91
../DataSets\DelayGraph_532.graphml,381,442,823,0.0025000572204589844,91
../DataSets\DelayGraph_533.graphml,212,228,440,0.0,37
../DataSets\DelayGraph_534.graphml,210,219,429,0.0,40
../DataSets\DelayGraph_535.graphml,118,122,240,0.0,21
../DataSets\DelayGraph_536.graphml,31,32,63,0.0,5
../DataSets\DelayGraph_537.graphml,31,32,63,0.0,5
../DataSets\DelayGraph_538.graphml,130,128,258,0.0,36
../DataSets\DelayGraph_539.graphml,1186,1571,2757,0.0025000572204589844,269185820927465307946
../DataSets\DelayGraph_540.graphml,63,71,134,0.0025000572204589844,12
../DataSets\DelayGraph_541.graphml,116,135,251,0.0,64
../DataSets\DelayGraph_542.graphml,844,1031,1875,0.0025000572204589844,26988206103
../DataSets\DelayGraph_543.graphml,428,519,947,0.002499818801879883,320947
../DataSets\DelayGraph_544.graphml,1186,1571,2757,0.0025000572204589844,269185820927465307946
../DataSets\DelayGraph_545.graphml,220,263,483,0.002499818801879883,1214
../DataSets\DelayGraph_546.graphml,1234,1549,2783,0.0034999847412109375,76519827268721167762
../DataSets\DelayGraph_547.graphml,443,459,902,0.0,97
../DataSets\DelayGraph_548.graphml,137,133,270,0.0,19
../DataSets\DelayGraph_549.graphml,139,149,288,0.0,19
../DataSets\DelayGraph_550.graphml,139,149,288,0.0,20
../DataSets\DelayGraph_551.graphml,81,89,170,0.0,15
../DataSets\DelayGraph_552.graphml,81,89,170,0.0,15
../DataSets\DelayGraph_553.graphml,23,23,46,0.0,6
../DataSets\DelayGraph_554.graphml,137,139,276,0.0025000572204589844,19
../DataSets\DelayGraph_555.graphml,517,713,1230,0.0,1036
../DataSets\DelayGraph_556.graphml,517,713,1230,0.0,1036
../DataSets\DelayGraph_557.graphml,33,36,69,0.0,6
../DataSets\DelayGraph_558.graphml,170,181,351,0.0,4
../DataSets\DelayGraph_559.graphml,26,25,51,0.0,7
../DataSets\DelayGraph_560.graphml,3,2,5,0.0,1
../DataSets\DelayGraph_561.graphml,3,2,5,0.0,1
../DataSets\DelayGraph_562.graphml,25,23,48,0.0,6
../DataSets\DelayGraph_563.graphml,25,23,48,0.0,6
../DataSets\DelayGraph_564.graphml,48,42,90,0.0,11
../DataSets\DelayGraph_565.graphml,75,79,154,0.0,22
../DataSets\DelayGraph_566.graphml,487,542,1029,0.0,336
../DataSets\DelayGraph_567.graphml,487,542,1029,0.002499818801879883,336
../DataSets\DelayGraph_568.graphml,13,12,25,0.0,3
../DataSets\DelayGraph_569.graphml,13,12,25,0.0,3
../DataSets\DelayGraph_570.graphml,28,27,55,0.0,2
../DataSets\DelayGraph_571.graphml,150,177,327,0.0,313
../DataSets\DelayGraph_572.graphml,1057,1368,2425,0.005000114440917969,48593138177403464450
../DataSets\DelayGraph_573.graphml,150,177,327,0.0,288
../DataSets\DelayGraph_574.graphml,28,27,55,0.0,2
../DataSets\DelayGraph_575.graphml,209715,279292,489007,1.498499870300293,139158
../DataSets\DelayGraph_576.graphml,3822,4148,7970,0.017499923706054688,299
../DataSets\DelayGraph_577.graphml,10,9,19,0.0,1
../DataSets\DelayGraph_578.graphml,10,9,19,0.0,1
../DataSets\DelayGraph_579.graphml,943,1007,1950,0.002499818801879883,510
../DataSets\DelayGraph_580.graphml,943,1007,1950,0.0025000572204589844,510
../DataSets\DelayGraph_581.graphml,63,66,129,0.0,18
../DataSets\DelayGraph_582.graphml,99,110,209,0.0,46
../DataSets\DelayGraph_583.graphml,99,110,209,0.0,46
../DataSets\DelayGraph_584.graphml,98,104,202,0.0025000572204589844,8
../DataSets\DelayGraph_585.graphml,18,17,35,0.0,3
../DataSets\DelayGraph_586.graphml,236,245,481,0.0,51
../DataSets\DelayGraph_587.graphml,224,267,491,0.0009999275207519531,105
../DataSets\DelayGraph_588.graphml,224,267,491,0.0,105
../DataSets\DelayGraph_589.graphml,86,81,167,0.0,14
../DataSets\DelayGraph_590.graphml,86,81,167,0.0,14
../DataSets\DelayGraph_591.graphml,86,81,167,0.0,17
../DataSets\DelayGraph_592.graphml,505,560,1065,0.0,145
../DataSets\DelayGraph_593.graphml,1328,1593,2921,0.004999876022338867,560
../DataSets\DelayGraph_594.graphml,1328,1593,2921,0.0025000572204589844,560
../DataSets\DelayGraph_595.graphml,123,139,262,0.0,57
../DataSets\DelayGraph_596.graphml,123,139,262,0.0,57
../DataSets\DelayGraph_597.graphml,123,139,262,0.0,57
../DataSets\DelayGraph_598.graphml,89,87,176,0.0,15
../DataSets\DelayGraph_599.graphml,89,87,176,0.0,16
../DataSets\DelayGraph_600.graphml,89,87,176,0.0,20
../DataSets\DelayGraph_601.graphml,157,159,316,0.0,15
../DataSets\DelayGraph_602.graphml,604,699,1303,0.0,196
../DataSets\DelayGraph_603.graphml,604,699,1303,0.0,196
../DataSets\DelayGraph_604.graphml,933,1148,2081,0.0,478
../DataSets\DelayGraph_605.graphml,34786,53526,88312,0.19499993324279785,5011337102401836053792582472713345902569740610
../DataSets\DelayGraph_606.graphml,17759,21376,39135,0.08000016212463379,7768912356733746474362594233318940861574297080270468157482281202452769490564798415563617056249786169938612088655947630693567501
../DataSets\DelayGraph_607.graphml,17759,21376,39135,0.07999992370605469,7768912356733746474362594233318940861574297080270468157482281202452769490564798415563617056249786169938612088655947630693567501
../DataSets\DelayGraph_608.graphml,273,315,588,0.0025000572204589844,296
../DataSets\DelayGraph_609.graphml,6013,7224,13237,0.019999980926513672,10488241753700873040115096918848632668892482
../DataSets\DelayGraph_610.graphml,6013,7224,13237,0.02499985694885254,10488241753700873040115096918848632668892482
../DataSets\DelayGraph_611.graphml,543,633,1176,0.0025000572204589844,374
../DataSets\DelayGraph_612.graphml,5995,7211,13206,0.017499923706054688,8430436840869852858870725134222982014176047
../DataSets\DelayGraph_613.graphml,5995,7211,13206,0.029999971389770508,8448048900592237174880151730633075137615781
../DataSets\DelayGraph_614.graphml,163,175,338,0.0,53
../DataSets\DelayGraph_615.graphml,174,182,356,0.0,50
../DataSets\DelayGraph_616.graphml,174,182,356,0.0,50
../DataSets\DelayGraph_617.graphml,731,801,1532,0.0,172
../DataSets\DelayGraph_618.graphml,1403,1864,3267,0.0025000572204589844,506
../DataSets\DelayGraph_619.graphml,26393,33302,59695,0.11999988555908203,310168
../DataSets\DelayGraph_620.graphml,26393,33302,59695,0.1614999771118164,310168
../DataSets\DelayGraph_621.graphml,220,263,483,0.0,1067
../DataSets\DelayGraph_622.graphml,428,519,947,0.0025000572204589844,435294
../DataSets\DelayGraph_623.graphml,844,1031,1875,0.0025000572204589844,34222840468
../DataSets\DelayGraph_624.graphml,1186,1571,2757,0.0025000572204589844,269185820927465307946
../DataSets\DelayGraph_625.graphml,1234,1549,2783,0.003000020980834961,92916933112018481418
../DataSets\DelayGraph_626.graphml,63,71,134,0.0,13
../DataSets\DelayGraph_627.graphml,116,135,251,0.0,73
../DataSets\DelayGraph_628.graphml,1186,1571,2757,0.0025000572204589844,269185820927465307946
../DataSets\DelayGraph_629.graphml,447,463,910,0.0,91
../DataSets\DelayGraph_630.graphml,39,34,73,0.0,7
../DataSets\DelayGraph_631.graphml,244,248,492,0.0,35
../DataSets\DelayGraph_632.graphml,71,77,148,0.0,12
../DataSets\DelayGraph_633.graphml,8,7,15,0.0,2
../DataSets\DelayGraph_634.graphml,8,7,15,0.0,2
../DataSets\DelayGraph_635.graphml,122,144,266,0.0025000572204589844,141
../DataSets\DelayGraph_636.graphml,49,53,102,0.0025000572204589844,12
../DataSets\DelayGraph_637.graphml,49,53,102,0.0,12
../DataSets\DelayGraph_638.graphml,22,20,42,0.0,3
../DataSets\DelayGraph_639.graphml,22,20,42,0.0,3
../DataSets\DelayGraph_640.graphml,132,143,275,0.0,41
../DataSets\DelayGraph_641.graphml,2136,2506,4642,0.006000041961669922,244400262023715
../DataSets\DelayGraph_642.graphml,2136,2506,4642,0.004999876022338867,244400262023715
../DataSets\DelayGraph_643.graphml,64,69,133,0.0,20
../DataSets\DelayGraph_644.graphml,32,35,67,0.0,14
../DataSets\DelayGraph_645.graphml,32,35,67,0.0,14
../DataSets\DelayGraph_646.graphml,42,53,95,0.0,29
../DataSets\DelayGraph_647.graphml,42,53,95,0.0,29
../DataSets\DelayGraph_648.graphml,155,162,317,0.0,20
../DataSets\DelayGraph_649.graphml,155,162,317,0.0,20
../DataSets\DelayGraph_650.graphml,133,139,272,0.0,16
../DataSets\DelayGraph_651.graphml,133,139,272,0.0,16
../DataSets\DelayGraph_652.graphml,144,143,287,0.0,1
../DataSets\DelayGraph_653.graphml,61,69,130,0.0,12
../DataSets\DelayGraph_654.graphml,320,417,737,0.0,956258
../DataSets\DelayGraph_655.graphml,61,69,130,0.0,12
../DataSets\DelayGraph_656.graphml,144,143,287,0.0,1
../DataSets\DelayGraph_657.graphml,170,186,356,0.0,47
../DataSets\DelayGraph_658.graphml,665,766,1431,0.0025000572204589844,415057
../DataSets\DelayGraph_659.graphml,726,910,1636,0.0025000572204589844,82404682499
../DataSets\DelayGraph_660.graphml,711,894,1605,0.0025000572204589844,197450469442
../DataSets\DelayGraph_661.graphml,126,148,274,0.0,51
../DataSets\DelayGraph_662.graphml,711,894,1605,0.0025000572204589844,197450469442
../DataSets\DelayGraph_663.graphml,572,753,1325,0.002499818801879883,15668676769
../DataSets\DelayGraph_664.graphml,572,753,1325,0.0025000572204589844,15668676769
../DataSets\DelayGraph_665.graphml,61,69,130,0.0,13
../DataSets\DelayGraph_666.graphml,425,517,942,0.0,277442
../DataSets\DelayGraph_667.graphml,665,766,1431,0.0,415057
../DataSets\DelayGraph_668.graphml,420,470,890,0.0,404
../DataSets\DelayGraph_669.graphml,2460,2733,5193,0.005000114440917969,2401
../DataSets\DelayGraph_670.graphml,2460,2733,5193,0.0025000572204589844,2401
../DataSets\DelayGraph_671.graphml,74,71,145,0.0,8
../DataSets\DelayGraph_672.graphml,74,71,145,0.0,8
../DataSets\DelayGraph_673.graphml,650,653,1303,0.002499818801879883,15
../DataSets\DelayGraph_674.graphml,7887,7931,15818,0.020999908447265625,137
../DataSets\DelayGraph_675.graphml,2289,2298,4587,0.004999876022338867,57
../DataSets\DelayGraph_676.graphml,4311,4333,8644,0.010499954223632812,94
../DataSets\DelayGraph_677.graphml,5864,5966,11830,0.01250004768371582,294920
../DataSets\DelayGraph_678.graphml,7887,7931,15818,0.017499923706054688,137
../DataSets\DelayGraph_679.graphml,30,24,54,0.0,6
../DataSets\DelayGraph_680.graphml,30,24,54,0.0,6
../DataSets\DelayGraph_681.graphml,328,347,675,0.0,50
../DataSets\DelayGraph_682.graphml,408,537,945,0.0009999275207519531,127
../DataSets\DelayGraph_683.graphml,1047,1493,2540,0.0025000572204589844,33103715
../DataSets\DelayGraph_684.graphml,1047,1493,2540,0.0025000572204589844,33103715
../DataSets\DelayGraph_685.graphml,44,44,88,0.0,9
../DataSets\DelayGraph_686.graphml,6,5,11,0.0,1
../DataSets\DelayGraph_687.graphml,26,30,56,0.0,5
../DataSets\DelayGraph_688.graphml,26,30,56,0.0,5
../DataSets\DelayGraph_689.graphml,13,10,23,0.0,3
../DataSets\DelayGraph_690.graphml,13,10,23,0.0,3
../DataSets\DelayGraph_691.graphml,13,10,23,0.0,3
../DataSets\DelayGraph_692.graphml,168,172,340,0.0,36
../DataSets\DelayGraph_693.graphml,355,400,755,0.0,95
../DataSets\DelayGraph_694.graphml,355,400,755,0.0,95
../DataSets\DelayGraph_695.graphml,56,57,113,0.0,14
../DataSets\DelayGraph_696.graphml,56,57,113,0.0,14
../DataSets\DelayGraph_697.graphml,56,57,113,0.0,14
../DataSets\DelayGraph_698.graphml,193,249,442,0.0,24
../DataSets\DelayGraph_699.graphml,193,249,442,0.0,23
../DataSets\DelayGraph_700.graphml,131,131,262,0.0,23
../DataSets\DelayGraph_701.graphml,18,17,35,0.0,3
../DataSets\DelayGraph_702.graphml,53,57,110,0.0,12
../DataSets\DelayGraph_703.graphml,53,57,110,0.0,12
../DataSets\DelayGraph_704.graphml,49,52,101,0.0,10
../DataSets\DelayGraph_705.graphml,525,721,1246,0.0,1016
../DataSets\DelayGraph_706.graphml,525,721,1246,0.0025000572204589844,1016
../DataSets\DelayGraph_707.graphml,137,139,276,0.0,19
../DataSets\DelayGraph_708.graphml,7306,9232,16538,0.02500009536743164,772
../DataSets\DelayGraph_709.graphml,2419,3108,5527,0.007999897003173828,1357
../DataSets\DelayGraph_710.graphml,1401,1862,3263,0.0025000572204589844,506
../DataSets\DelayGraph_711.graphml,13459,16912,30371,0.04250001907348633,10188
../DataSets\DelayGraph_712.graphml,13459,16912,30371,0.047499895095825195,10188
../DataSets\DelayGraph_713.graphml,8,6,14,0.0025000572204589844,2
../DataSets\DelayGraph_714.graphml,8,6,14,0.0,2
../DataSets\DelayGraph_715.graphml,3,2,5,0.0,1
../DataSets\DelayGraph_716.graphml,4179,4178,8357,0.0074999332427978516,24
../DataSets\DelayGraph_717.graphml,44,23,67,0.0,21
../DataSets\DelayGraph_718.graphml,12,8,20,0.0,4
../DataSets\DelayGraph_719.graphml,12,8,20,0.0,4
../DataSets\DelayGraph_720.graphml,44,23,67,0.0,21
../DataSets\DelayGraph_721.graphml,12,8,20,0.0,4
../DataSets\DelayGraph_722.graphml,12,8,20,0.0,4
../DataSets\DelayGraph_723.graphml,44,23,67,0.0,21
../DataSets\DelayGraph_724.graphml,12,8,20,0.0,4
../DataSets\DelayGraph_725.graphml,8,6,14,0.0,2
../DataSets\DelayGraph_726.graphml,44,23,67,0.0,21
../DataSets\DelayGraph_727.graphml,12,8,20,0.0,4
../DataSets\DelayGraph_728.graphml,3,2,5,0.0,1
../DataSets\DelayGraph_729.graphml,3,2,5,0.0,1
../DataSets\DelayGraph_730.graphml,3,2,5,0.0,1
../DataSets\DelayGraph_731.graphml,3,2,5,0.0,1
../DataSets\DelayGraph_732.graphml,3,2,5,0.0,1
../DataSets\DelayGraph_733.graphml,3,2,5,0.0,1
../DataSets\DelayGraph_734.graphml,3,2,5,0.0,1
../DataSets\DelayGraph_735.graphml,80,81,161,0.0,12
../DataSets\DelayGraph_736.graphml,154,158,312,0.0,36
../DataSets\DelayGraph_737.graphml,9,8,17,0.0,2
../DataSets\DelayGraph_738.graphml,428,588,1016,0.0,1000
../DataSets\DelayGraph_739.graphml,428,588,1016,0.015599966049194336,1000
../DataSets\DelayGraph_740.graphml,359,483,842,0.0,343
../DataSets\DelayGraph_741.graphml,65,63,128,0.0,12
../DataSets\DelayGraph_742.graphml,42,44,86,0.0,15
../DataSets\DelayGraph_743.graphml,112,121,233,0.0,26
../DataSets\DelayGraph_744.graphml,415,486,901,0.0,1792
../DataSets\DelayGraph_745.graphml,415,486,901,0.0,1792
../DataSets\DelayGraph_746.graphml,148,170,318,0.0,53
../DataSets\DelayGraph_747.graphml,148,170,318,0.0,53
../DataSets\DelayGraph_748.graphml,92,92,184,0.0,5
../DataSets\DelayGraph_749.graphml,92,92,184,0.0,5
../DataSets\DelayGraph_750.graphml,60,63,123,0.0,14
../DataSets\DelayGraph_751.graphml,78,83,161,0.0,19
../DataSets\DelayGraph_752.graphml,172,182,354,0.0,16
../DataSets\DelayGraph_753.graphml,1060,1373,2433,0.0,145779414532210395240
../DataSets\DelayGraph_754.graphml,126,147,273,0.0,278
../DataSets\DelayGraph_755.graphml,126,147,273,0.0,275
../DataSets\DelayGraph_756.graphml,172,182,354,0.0,16
../DataSets\DelayGraph_757.graphml,28,26,54,0.0,6
../DataSets\DelayGraph_758.graphml,28,26,54,0.0,6
../DataSets\DelayGraph_759.graphml,240,315,555,0.0009999275207519531,1896
../DataSets\DelayGraph_760.graphml,240,315,555,0.0,1896
../DataSets\DelayGraph_761.graphml,43,42,85,0.0,8
../DataSets\DelayGraph_762.graphml,43,42,85,0.0,8
../DataSets\DelayGraph_763.graphml,58,62,120,0.0,12
../DataSets\DelayGraph_764.graphml,58,62,120,0.0,12
../DataSets\DelayGraph_765.graphml,96,98,194,0.0,10
../DataSets\DelayGraph_766.graphml,96,98,194,0.0,10
../DataSets\DelayGraph_767.graphml,72,76,148,0.0,20
../DataSets\DelayGraph_768.graphml,126,146,272,0.0,56
../DataSets\DelayGraph_769.graphml,126,146,272,0.0,56
../DataSets\DelayGraph_770.graphml,84,89,173,0.0,18
../DataSets\DelayGraph_771.graphml,126,146,272,0.0,54
../DataSets\DelayGraph_772.graphml,126,146,272,0.0,54
../DataSets\DelayGraph_773.graphml,505,535,1040,0.0,315
../DataSets\DelayGraph_774.graphml,605,656,1261,0.0,1948
../DataSets\DelayGraph_775.graphml,353,422,775,0.0,476
../DataSets\DelayGraph_776.graphml,61,69,130,0.0,13
../DataSets\DelayGraph_777.graphml,217,261,478,0.0,1306
../DataSets\DelayGraph_778.graphml,61,69,130,0.0,12
../DataSets\DelayGraph_779.graphml,284,369,653,0.0,239017
../DataSets\DelayGraph_780.graphml,284,369,653,0.0,239017
../DataSets\DelayGraph_781.graphml,353,422,775,0.015599966049194336,476
../DataSets\DelayGraph_782.graphml,53,48,101,0.0,9
../DataSets\DelayGraph_783.graphml,36,33,69,0.0,8
../DataSets\DelayGraph_784.graphml,36,33,69,0.0,8
../DataSets\DelayGraph_785.graphml,188,185,373,0.0,58
../DataSets\DelayGraph_786.graphml,541,930,1471,0.0,42
../DataSets\DelayGraph_787.graphml,541,930,1471,0.0,42
../DataSets\DelayGraph_788.graphml,48,44,92,0.0,10
../DataSets\DelayGraph_789.graphml,664,822,1486,0.0,385
../DataSets\DelayGraph_790.graphml,19738,29296,49034,0.04680013656616211,503088463845222890314447226324662260743797753
../DataSets\DelayGraph_791.graphml,11326,13664,24990,0.062399864196777344,31775582589729787664658169377039976820279707207178132365810981839015456498487762690199
../DataSets\DelayGraph_792.graphml,11326,13664,24990,0.04679989814758301,31775582589729787664658169377039976820279707207178132365810981839015456498487762690199
../DataSets\DelayGraph_793.graphml,53,57,110,0.0,12
../DataSets\DelayGraph_794.graphml,53,57,110,0.0,12
../DataSets\DelayGraph_795.graphml,77,81,158,0.0,12
../DataSets\DelayGraph_796.graphml,156,169,325,0.0,19
../DataSets\DelayGraph_797.graphml,156,169,325,0.0,19
../DataSets\DelayGraph_798.graphml,92,100,192,0.0,14
../DataSets\DelayGraph_799.graphml,131,146,277,0.0,30
../DataSets\DelayGraph_800.graphml,212,228,440,0.0,37
../DataSets\DelayGraph_801.graphml,212,228,440,0.0,37
../DataSets\DelayGraph_802.graphml,7306,9232,16538,0.015599966049194336,772
../DataSets\DelayGraph_803.graphml,1621,2101,3722,0.0,161
../DataSets\DelayGraph_804.graphml,6800,8788,15588,0.020000219345092773,772
../DataSets\DelayGraph_805.graphml,6800,8788,15588,0.019999980926513672,772
../DataSets\DelayGraph_806.graphml,20,20,40,0.0025000572204589844,4
../DataSets\DelayGraph_807.graphml,20,20,40,0.0,4
../DataSets\DelayGraph_808.graphml,1234,1549,2783,0.0025000572204589844,92916933112018481418
../DataSets\DelayGraph_809.graphml,116,135,251,0.0025000572204589844,59
../DataSets\DelayGraph_810.graphml,220,263,483,0.0,1555
../DataSets\DelayGraph_811.graphml,844,1031,1875,0.0025000572204589844,27586603230
../DataSets\DelayGraph_812.graphml,1186,1571,2757,0.0025000572204589844,269185820927465307946
../DataSets\DelayGraph_813.graphml,63,71,134,0.0,13
../DataSets\DelayGraph_814.graphml,1186,1571,2757,0.0025000572204589844,269185820927465307946
../DataSets\DelayGraph_815.graphml,428,519,947,0.0025000572204589844,292240
../DataSets\DelayGraph_816.graphml,492,505,997,0.0,105
../DataSets\DelayGraph_817.graphml,130,142,272,0.0,18
../DataSets\DelayGraph_818.graphml,130,142,272,0.0,18
../DataSets\DelayGraph_819.graphml,349,473,822,0.0025000572204589844,244
../DataSets\DelayGraph_820.graphml,81,95,176,0.0,16
../DataSets\DelayGraph_821.graphml,78,83,161,0.0,19
../DataSets\DelayGraph_822.graphml,78,83,161,0.0025000572204589844,8
../DataSets\DelayGraph_823.graphml,78,83,161,0.0,8
../DataSets\DelayGraph_824.graphml,30,22,52,0.0,10
../DataSets\DelayGraph_825.graphml,30,22,52,0.0,10
../DataSets\DelayGraph_826.graphml,40,40,80,0.0,7
../DataSets\DelayGraph_827.graphml,2799,3568,6367,0.004999876022338867,73754
../DataSets\DelayGraph_828.graphml,375,393,768,0.0,132
../DataSets\DelayGraph_829.graphml,2020,2988,5008,0.005000114440917969,99036
../DataSets\DelayGraph_830.graphml,113,133,246,0.0025000572204589844,73
../DataSets\DelayGraph_831.graphml,425,517,942,0.0,332589
../DataSets\DelayGraph_832.graphml,61,69,130,0.0,13
../DataSets\DelayGraph_833.graphml,841,1029,1870,0.0025000572204589844,19807113314
../DataSets\DelayGraph_834.graphml,113,133,246,0.0,70
../DataSets\DelayGraph_835.graphml,1148,1521,2669,0.0025000572204589844,67296455231866326417
../DataSets\DelayGraph_836.graphml,217,261,478,0.0,1163
../DataSets\DelayGraph_837.graphml,1148,1521,2669,0.0025000572204589844,67296455231866326417
../DataSets\DelayGraph_838.graphml,375,393,768,0.0025000572204589844,132
../DataSets\DelayGraph_839.graphml,80,87,167,0.0,23
../DataSets\DelayGraph_840.graphml,28,28,56,0.0,5
../DataSets\DelayGraph_841.graphml,28,28,56,0.0,5
../DataSets\DelayGraph_842.graphml,146,153,299,0.0,18
../DataSets\DelayGraph_843.graphml,146,153,299,0.0,18
../DataSets\DelayGraph_844.graphml,112,121,233,0.0,18
../DataSets\DelayGraph_845.graphml,112,121,233,0.0,18
../DataSets\DelayGraph_846.graphml,112,121,233,0.0,18
../DataSets\DelayGraph_847.graphml,106,108,214,0.0,19
../DataSets\DelayGraph_848.graphml,114,132,246,0.0,26
../DataSets\DelayGraph_849.graphml,767,964,1731,0.0025000572204589844,1585027642257
../DataSets\DelayGraph_850.graphml,767,964,1731,0.0025000572204589844,1585027642257
../DataSets\DelayGraph_851.graphml,790,976,1766,0.0,46494522868
../DataSets\DelayGraph_852.graphml,106,108,214,0.0,19
../DataSets\DelayGraph_853.graphml,127,145,272,0.0,35
../DataSets\DelayGraph_854.graphml,127,145,272,0.0,35
../DataSets\DelayGraph_855.graphml,127,145,272,0.0,35
../DataSets\DelayGraph_856.graphml,14,12,26,0.0,2
../DataSets\DelayGraph_857.graphml,14,12,26,0.0,2
../DataSets\DelayGraph_858.graphml,3758,5438,9196,0.0074999332427978516,4734
../DataSets\DelayGraph_859.graphml,27998,36878,64876,0.1724998950958252,1155362
../DataSets\DelayGraph_860.graphml,26895,38715,65610,0.19749999046325684,456596295024
../DataSets\DelayGraph_861.graphml,27998,36878,64876,0.13000011444091797,1155362
../DataSets\DelayGraph_862.graphml,2429,2550,4979,0.009999990463256836,407
../DataSets\DelayGraph_863.graphml,6550,7615,14165,0.019999980926513672,7588529443444296
../DataSets\DelayGraph_864.graphml,1086,1407,2493,0.003000020980834961,437338243596631187737
../DataSets\DelayGraph_865.graphml,1086,1407,2493,0.0025000572204589844,437338243596631187737
../DataSets\DelayGraph_866.graphml,1111,1372,2483,0.0025000572204589844,283912644584444879
../DataSets\DelayGraph_867.graphml,127,148,275,0.0,316
../DataSets\DelayGraph_868.graphml,898,1187,2085,0.0,4107449660147602
../DataSets\DelayGraph_869.graphml,738,909,1647,0.002499818801879883,18249333325
../DataSets\DelayGraph_870.graphml,63,71,134,0.0,13
../DataSets\DelayGraph_871.graphml,898,1187,2085,0.0025000572204589844,4107449660147602
../DataSets\DelayGraph_872.graphml,6550,7615,14165,0.029999971389770508,7588529443444296
../DataSets\DelayGraph_873.graphml,171,184,355,0.0009999275207519531,30
../DataSets\DelayGraph_874.graphml,7,5,12,0.0,2
../DataSets\DelayGraph_875.graphml,88,94,182,0.0,24
../DataSets\DelayGraph_876.graphml,17,17,34,0.0,2
../DataSets\DelayGraph_877.graphml,80,85,165,0.0,21
../DataSets\DelayGraph_878.graphml,236,245,481,0.0,51
../DataSets\DelayGraph_879.graphml,224,267,491,0.0,105
../DataSets\DelayGraph_880.graphml,224,267,491,0.0,105
../DataSets\DelayGraph_881.graphml,94,96,190,0.0,23
../DataSets\DelayGraph_882.graphml,78,95,173,0.0,37
../DataSets\DelayGraph_883.graphml,78,95,173,0.0,37
../DataSets\DelayGraph_884.graphml,262,292,554,0.002499818801879883,65
../DataSets\DelayGraph_885.graphml,262,292,554,0.0,65
../DataSets\DelayGraph_886.graphml,262,292,554,0.0,65
../DataSets\DelayGraph_887.graphml,310,340,650,0.0,70
../DataSets\DelayGraph_888.graphml,78,84,162,0.0,22
../DataSets\DelayGraph_889.graphml,78,84,162,0.0,22
../DataSets\DelayGraph_890.graphml,193,249,442,0.0,22
../DataSets\DelayGraph_891.graphml,31,33,64,0.0,5
../DataSets\DelayGraph_892.graphml,31,33,64,0.0,5
../DataSets\DelayGraph_893.graphml,43,44,87,0.0025000572204589844,6
../DataSets\DelayGraph_894.graphml,358,402,760,0.0,63
../DataSets\DelayGraph_895.graphml,238,262,500,0.0,27
../DataSets\DelayGraph_896.graphml,107,111,218,0.0,15
../DataSets\DelayGraph_897.graphml,949,1052,2001,0.0,134
../DataSets\DelayGraph_898.graphml,493,545,1038,0.0025000572204589844,66
../DataSets\DelayGraph_899.graphml,493,545,1038,0.0025000572204589844,66
../DataSets\DelayGraph_900.graphml,533,563,1096,0.002499818801879883,59
../DataSets\DelayGraph_901.graphml,557,587,1144,0.0,59
../DataSets\DelayGraph_902.graphml,20,21,41,0.0,6
../DataSets\DelayGraph_903.graphml,20,21,41,0.0,6
../DataSets\DelayGraph_904.graphml,51,54,105,0.0025000572204589844,12
../DataSets\DelayGraph_905.graphml,527,723,1250,0.0,1019
../DataSets\DelayGraph_906.graphml,527,723,1250,0.0025000572204589844,1019
../DataSets\DelayGraph_907.graphml,11,8,19,0.0,3
../DataSets\DelayGraph_908.graphml,233,242,475,0.0009999275207519531,40
../DataSets\DelayGraph_909.graphml,2479,3162,5641,0.004999876022338867,1357
../DataSets\DelayGraph_910.graphml,1186,1571,2757,0.0025000572204589844,269185820927465307946
../DataSets\DelayGraph_911.graphml,63,71,134,0.0,13
../DataSets\DelayGraph_912.graphml,220,263,483,0.0,1331
../DataSets\DelayGraph_913.graphml,116,135,251,0.0,92
../DataSets\DelayGraph_914.graphml,1186,1571,2757,0.0025000572204589844,269185820927465307946
../DataSets\DelayGraph_915.graphml,844,1031,1875,0.0025000572204589844,22211339565
../DataSets\DelayGraph_916.graphml,428,519,947,0.002499818801879883,503192
../DataSets\DelayGraph_917.graphml,1234,1549,2783,0.0025000572204589844,81131513287148490130
../DataSets\DelayGraph_918.graphml,443,459,902,0.0025000572204589844,96
../DataSets\DelayGraph_919.graphml,244,248,492,0.0,35
../DataSets\DelayGraph_920.graphml,119,126,245,0.0,22
../DataSets\DelayGraph_921.graphml,95,100,195,0.0,34
../DataSets\DelayGraph_922.graphml,136,153,289,0.0,22
../DataSets\DelayGraph_923.graphml,136,153,289,0.0025000572204589844,22
../DataSets\DelayGraph_924.graphml,666,923,1589,0.0025000572204589844,818
../DataSets\DelayGraph_925.graphml,666,923,1589,0.002499818801879883,818
../DataSets\DelayGraph_926.graphml,183,257,440,0.0,699
../DataSets\DelayGraph_927.graphml,183,257,440,0.0009999275207519531,699
../DataSets\DelayGraph_928.graphml,191,252,443,0.0,141
../DataSets\DelayGraph_929.graphml,2902,3663,6565,0.004999876022338867,73754
../DataSets\DelayGraph_930.graphml,30,29,59,0.0,8
../DataSets\DelayGraph_931.graphml,119,123,242,0.0,25
../DataSets\DelayGraph_932.graphml,189,196,385,0.002499818801879883,40
../DataSets\DelayGraph_933.graphml,114,132,246,0.0,26
../DataSets\DelayGraph_934.graphml,767,964,1731,0.0,1585027642257
../DataSets\DelayGraph_935.graphml,790,976,1766,0.0,46494522868
../DataSets\DelayGraph_936.graphml,767,964,1731,0.0025000572204589844,1585027642257
../DataSets\DelayGraph_937.graphml,119,123,242,0.0009999275207519531,26
../DataSets\DelayGraph_938.graphml,66,69,135,0.0,18
../DataSets\DelayGraph_939.graphml,66,69,135,0.0,18
../DataSets\DelayGraph_940.graphml,92,90,182,0.002499818801879883,15
../DataSets\DelayGraph_941.graphml,92,90,182,0.0,15
../DataSets\DelayGraph_942.graphml,134,135,269,0.0,13
../DataSets\DelayGraph_943.graphml,134,135,269,0.0,12
../DataSets\DelayGraph_944.graphml,2902,3663,6565,0.005000114440917969,73754
../DataSets\DelayGraph_945.graphml,18754,22976,41730,0.06500005722045898,1571361120146360325
../DataSets\DelayGraph_946.graphml,5031,6160,11191,0.01250004768371582,4016974
../DataSets\DelayGraph_947.graphml,3695,4592,8287,0.009999990463256836,402718
../DataSets\DelayGraph_948.graphml,3695,4592,8287,0.0074999332427978516,402718
../DataSets\DelayGraph_949.graphml,193,204,397,0.0,6
../DataSets\DelayGraph_950.graphml,238,250,488,0.0,4
../DataSets\DelayGraph_951.graphml,330,360,690,0.002499818801879883,23
../DataSets\DelayGraph_952.graphml,220,263,483,0.0,1168
../DataSets\DelayGraph_953.graphml,116,135,251,0.0,71
../DataSets\DelayGraph_954.graphml,63,71,134,0.0,13
../DataSets\DelayGraph_955.graphml,428,519,947,0.0009999275207519531,419797
../DataSets\DelayGraph_956.graphml,1762,2339,4101,0.002499818801879883,1156144297430375889328011717978
../DataSets\DelayGraph_957.graphml,1762,2339,4101,0.005000114440917969,1156144297430375889328011717978
../DataSets\DelayGraph_958.graphml,1458,1805,3263,0.0025000572204589844,91830956526322881505
../DataSets\DelayGraph_959.graphml,844,1031,1875,0.0025000572204589844,21679656856
../DataSets\DelayGraph_960.graphml,330,360,690,0.0,23
../DataSets\DelayGraph_961.graphml,2316,3097,5413,0.005000114440917969,4399
../DataSets\DelayGraph_962.graphml,4649,21538,26187,0.015000104904174805,82
../DataSets\DelayGraph_963.graphml,2600,3506,6106,0.00800013542175293,5854
../DataSets\DelayGraph_964.graphml,2600,3506,6106,0.004999876022338867,5854
../DataSets\DelayGraph_965.graphml,224,262,486,0.0,52
../DataSets\DelayGraph_966.graphml,1674,2134,3808,0.003999948501586914,50818514515202
../DataSets\DelayGraph_967.graphml,1674,2134,3808,0.003999948501586914,50818514515202
../DataSets\DelayGraph_968.graphml,49,51,100,0.0,15
../DataSets\DelayGraph_969.graphml,1797,1995,3792,0.005000114440917969,200
../DataSets\DelayGraph_970.graphml,1797,1995,3792,0.0074999332427978516,200
../DataSets\DelayGraph_971.graphml,35,34,69,0.0,8
../DataSets\DelayGraph_972.graphml,35,34,69,0.0025000572204589844,8
../DataSets\DelayGraph_973.graphml,43,42,85,0.0,8
../DataSets\DelayGraph_974.graphml,43,42,85,0.0,8
../DataSets\DelayGraph_975.graphml,634,711,1345,0.002499818801879883,1253
../DataSets\DelayGraph_976.graphml,662,745,1407,0.0,2264
../DataSets\DelayGraph_977.graphml,662,745,1407,0.0025000572204589844,2264
../DataSets\DelayGraph_978.graphml,17,16,33,0.0,2
../DataSets\DelayGraph_979.graphml,17,16,33,0.0,2
../DataSets\DelayGraph_980.graphml,327,346,673,0.0,51
../DataSets\DelayGraph_981.graphml,502,737,1239,0.0,226
../DataSets\DelayGraph_982.graphml,3801,5557,9358,0.009999990463256836,562697844905245
../DataSets\DelayGraph_983.graphml,3801,5557,9358,0.009999990463256836,562697844905245
../DataSets\DelayGraph_984.graphml,76,84,160,0.0,52
../DataSets\DelayGraph_985.graphml,76,84,160,0.0,52
../DataSets\DelayGraph_986.graphml,42,41,83,0.0,5
../DataSets\DelayGraph_987.graphml,88,94,182,0.0,24
../DataSets\DelayGraph_988.graphml,6,5,11,0.0,1
../DataSets\DelayGraph_989.graphml,28,27,55,0.0,2
../DataSets\DelayGraph_990.graphml,126,148,274,0.0,51
../DataSets\DelayGraph_991.graphml,385,454,839,0.002499818801879883,4142
../DataSets\DelayGraph_992.graphml,725,858,1583,0.0,1319346
../DataSets\DelayGraph_993.graphml,711,894,1605,0.0025000572204589844,197450469442
../DataSets\DelayGraph_994.graphml,385,454,839,0.0009999275207519531,4142
../DataSets\DelayGraph_995.graphml,726,910,1636,0.0,82404682499
../DataSets\DelayGraph_996.graphml,213,250,463,0.002499818801879883,196
../DataSets\DelayGraph_997.graphml,28,27,55,0.0,2
../DataSets\DelayGraph_998.graphml,80,85,165,0.0,19
../DataSets\DelayGraph_999.graphml,66,69,135,0.0,17
../DataSets\DelayGraph_1000.graphml,66,69,135,0.0025000572204589844,17
../DataSets\DelayGraph_1001.graphml,66,69,135,0.0,23
../DataSets\DelayGraph_1002.graphml,705,793,1498,0.002000093460083008,231
../DataSets\DelayGraph_1003.graphml,705,793,1498,0.0025000572204589844,231
../DataSets\DelayGraph_1004.graphml,279,306,585,0.0025000572204589844,74
../DataSets\DelayGraph_1005.graphml,289,330,619,0.0,102
../DataSets\DelayGraph_1006.graphml,106,135,241,0.0025000572204589844,72
../DataSets\DelayGraph_1007.graphml,106,135,241,0.0,72
../DataSets\DelayGraph_1008.graphml,15,13,28,0.0,3
../DataSets\DelayGraph_1009.graphml,50,53,103,0.0,10
../DataSets\DelayGraph_1010.graphml,8061,11137,19198,0.022500038146972656,15656
../DataSets\DelayGraph_1011.graphml,8061,11137,19198,0.017499923706054688,15656
../DataSets\DelayGraph_1012.graphml,24,25,49,0.0025000572204589844,6
../DataSets\DelayGraph_1013.graphml,66,72,138,0.0,20
../DataSets\DelayGraph_1014.graphml,172,189,361,0.0,21
../DataSets\DelayGraph_1015.graphml,1234,1549,2783,0.0025000572204589844,76519827385162437781
../DataSets\DelayGraph_1016.graphml,1186,1571,2757,0.0025000572204589844,269185820927465307946
../DataSets\DelayGraph_1017.graphml,220,263,483,0.0025000572204589844,1146
../DataSets\DelayGraph_1018.graphml,844,1031,1875,0.0,24544777806
../DataSets\DelayGraph_1019.graphml,428,519,947,0.0,301459
../DataSets\DelayGraph_1020.graphml,1186,1571,2757,0.0025000572204589844,269185820927465307946
../DataSets\DelayGraph_1021.graphml,63,71,134,0.0,13
../DataSets\DelayGraph_1022.graphml,116,135,251,0.0,74
../DataSets\DelayGraph_1023.graphml,475,488,963,0.0,101
../DataSets\DelayGraph_1024.graphml,63,71,134,0.0,13
../DataSets\DelayGraph_1025.graphml,1234,1549,2783,0.002499818801879883,92916933112018481418
../DataSets\DelayGraph_1026.graphml,1186,1571,2757,0.0025000572204589844,269185820927465307946
../DataSets\DelayGraph_1027.graphml,1186,1571,2757,0.002499818801879883,269185820927465307946
../DataSets\DelayGraph_1028.graphml,844,1031,1875,0.0025000572204589844,25911106052
../DataSets\DelayGraph_1029.graphml,220,263,483,0.0,1303
../DataSets\DelayGraph_1030.graphml,428,519,947,0.0025000572204589844,550636
../DataSets\DelayGraph_1031.graphml,116,135,251,0.0,59
../DataSets\DelayGraph_1032.graphml,447,463,910,0.0,93
../DataSets\DelayGraph_1033.graphml,48,47,95,0.0,13
../DataSets\DelayGraph_1034.graphml,48,47,95,0.0,13
../DataSets\DelayGraph_1035.graphml,210,219,429,0.0025000572204589844,40
../DataSets\DelayGraph_1036.graphml,103,116,219,0.0,260
../DataSets\DelayGraph_1037.graphml,249,293,542,0.0,168
../DataSets\DelayGraph_1038.graphml,249,293,542,0.0,168
../DataSets\DelayGraph_1039.graphml,50,62,112,0.0,33
../DataSets\DelayGraph_1040.graphml,85,94,179,0.0,17
../DataSets\DelayGraph_1041.graphml,85,94,179,0.0,17
../DataSets\DelayGraph_1042.graphml,34,39,73,0.0,17
../DataSets\DelayGraph_1043.graphml,34,39,73,0.0,17
../DataSets\DelayGraph_1044.graphml,305,328,633,0.0,94
../DataSets\DelayGraph_1045.graphml,305,328,633,0.002499818801879883,94
../DataSets\DelayGraph_1046.graphml,123,136,259,0.0,21
../DataSets\DelayGraph_1047.graphml,123,136,259,0.0,21
../DataSets\DelayGraph_1048.graphml,123,136,259,0.0,21
../DataSets\DelayGraph_1049.graphml,699,798,1497,0.0,1851
../DataSets\DelayGraph_1050.graphml,6123,7101,13224,0.02500009536743164,1786
../DataSets\DelayGraph_1051.graphml,2337,3266,5603,0.004999876022338867,402654250
../DataSets\DelayGraph_1052.graphml,6123,7101,13224,0.017499923706054688,1705
../DataSets\DelayGraph_1053.graphml,69,70,139,0.0,8
../DataSets\DelayGraph_1054.graphml,1053,1082,2135,0.002499818801879883,125
../DataSets\DelayGraph_1055.graphml,1053,1082,2135,0.0025000572204589844,125
../DataSets\DelayGraph_1056.graphml,463,511,974,0.0,399
../DataSets\DelayGraph_1057.graphml,2997,3256,6253,0.004999876022338867,2670
../DataSets\DelayGraph_1058.graphml,2997,3256,6253,0.0074999332427978516,2670
../DataSets\DelayGraph_1059.graphml,1612,2088,3700,0.002499818801879883,161
../DataSets\DelayGraph_1060.graphml,7306,9232,16538,0.02499985694885254,772
../DataSets\DelayGraph_1061.graphml,2479,3162,5641,0.005000114440917969,1357
../DataSets\DelayGraph_1062.graphml,1901,2448,4349,0.004999876022338867,693
../DataSets\DelayGraph_1063.graphml,1901,2448,4349,0.005000114440917969,693
../DataSets\DelayGraph_1064.graphml,172,183,355,0.0,4
../DataSets\DelayGraph_1065.graphml,139,149,288,0.0010001659393310547,16
../DataSets\DelayGraph_1066.graphml,126,147,273,0.0,316
../DataSets\DelayGraph_1067.graphml,1060,1373,2433,0.0025000572204589844,145779414532210395240
../DataSets\DelayGraph_1068.graphml,126,147,273,0.0025000572204589844,22514195294549868379
../DataSets\DelayGraph_1069.graphml,139,149,288,0.0,16
../DataSets\DelayGraph_1070.graphml,47,47,94,0.0,8
../DataSets\DelayGraph_1071.graphml,188,199,387,0.0,14
../DataSets\DelayGraph_1072.graphml,99,104,203,0.0,24
../DataSets\DelayGraph_1073.graphml,298,383,681,0.0,190
../DataSets\DelayGraph_1074.graphml,298,383,681,0.0,190
../DataSets\DelayGraph_1075.graphml,88,94,182,0.0,24
../DataSets\DelayGraph_1076.graphml,38,37,75,0.0,4
../DataSets\DelayGraph_1077.graphml,882,1106,1988,0.0025000572204589844,453313204489479
../DataSets\DelayGraph_1078.graphml,882,1106,1988,0.0,453313204489479
../DataSets\DelayGraph_1079.graphml,183,214,397,0.0,167
../DataSets\DelayGraph_1080.graphml,878,1083,1961,0.0025000572204589844,3648968262708
../DataSets\DelayGraph_1081.graphml,38,37,75,0.0,4
../DataSets\DelayGraph_1082.graphml,41,39,80,0.0,12
../DataSets\DelayGraph_1083.graphml,71,68,139,0.0,13
../DataSets\DelayGraph_1084.graphml,71,68,139,0.0,22
../DataSets\DelayGraph_1085.graphml,71,68,139,0.0,22
../DataSets\DelayGraph_1086.graphml,178,201,379,0.0,64
../DataSets\DelayGraph_1087.graphml,175,196,371,0.0,61
../DataSets\DelayGraph_1088.graphml,175,196,371,0.0,61
../DataSets\DelayGraph_1089.graphml,169,171,340,0.0,73
../DataSets\DelayGraph_1090.graphml,169,171,340,0.0,59
../DataSets\DelayGraph_1091.graphml,169,171,340,0.0,73
../DataSets\DelayGraph_1092.graphml,261,283,544,0.0,63
../DataSets\DelayGraph_1093.graphml,522,595,1117,0.0,273
../DataSets\DelayGraph_1094.graphml,54,63,117,0.0,28
../DataSets\DelayGraph_1095.graphml,54,63,117,0.0,28
../DataSets\DelayGraph_1096.graphml,363,370,733,0.0,89
../DataSets\DelayGraph_1097.graphml,838,1144,1982,0.0,36
../DataSets\DelayGraph_1098.graphml,838,1144,1982,0.0025000572204589844,36
../DataSets\DelayGraph_1099.graphml,70,67,137,0.0009999275207519531,12
../DataSets\DelayGraph_1100.graphml,70,67,137,0.0,12
../DataSets\DelayGraph_1101.graphml,110,128,238,0.0,26
../DataSets\DelayGraph_1102.graphml,368,456,824,0.0,585410
../DataSets\DelayGraph_1103.graphml,355,442,797,0.0,1400161
../DataSets\DelayGraph_1104.graphml,355,442,797,0.0025000572204589844,1400161
../DataSets\DelayGraph_1105.graphml,416,520,936,0.0,16158321
../DataSets\DelayGraph_1106.graphml,401,498,899,0.0,3235682
../DataSets\DelayGraph_1107.graphml,153,182,335,0.0,87
../DataSets\DelayGraph_1108.graphml,416,520,936,0.0,16158321
../DataSets\DelayGraph_1109.graphml,383,478,861,0.0,2800322
../DataSets\DelayGraph_1110.graphml,396,492,888,0.0,1170819
../DataSets\DelayGraph_1111.graphml,124,146,270,0.0,51
../DataSets\DelayGraph_1112.graphml,383,478,861,0.0,2800322
../DataSets\DelayGraph_1113.graphml,355,442,797,0.0,1400161
../DataSets\DelayGraph_1114.graphml,110,128,238,0.0,26
../DataSets\DelayGraph_1115.graphml,355,442,797,0.0,1400161
../DataSets\DelayGraph_1116.graphml,368,456,824,0.0010001659393310547,585410
../DataSets\DelayGraph_1117.graphml,70,67,137,0.0,8
../DataSets\DelayGraph_1118.graphml,30,28,58,0.0,6
../DataSets\DelayGraph_1119.graphml,157,162,319,0.0,17
../DataSets\DelayGraph_1120.graphml,109,122,231,0.0,37
../DataSets\DelayGraph_1121.graphml,2118,2516,4634,0.005000114440917969,13348859343668
../DataSets\DelayGraph_1122.graphml,2118,2516,4634,0.0074999332427978516,13348859343668
../DataSets\DelayGraph_1123.graphml,127,140,267,0.0,43
../DataSets\DelayGraph_1124.graphml,2071,2457,4528,0.004999876022338867,8764835393048
../DataSets\DelayGraph_1125.graphml,2071,2457,4528,0.005000114440917969,8764835393048
../DataSets\DelayGraph_1126.graphml,89,96,185,0.0,14
../DataSets\DelayGraph_1127.graphml,957,1112,2069,0.0025000572204589844,524328
../DataSets\DelayGraph_1128.graphml,1427,1569,2996,0.005000114440917969,380
../DataSets\DelayGraph_1129.graphml,1427,1569,2996,0.004999876022338867,380
../DataSets\DelayGraph_1130.graphml,89,96,185,0.0,14
../DataSets\DelayGraph_1131.graphml,131,146,277,0.0,30
../DataSets\DelayGraph_1132.graphml,212,228,440,0.0,37
../DataSets\DelayGraph_1133.graphml,212,228,440,0.0,37
../DataSets\DelayGraph_1134.graphml,1640,2121,3761,0.0025000572204589844,305
../DataSets\DelayGraph_1135.graphml,7243,8788,16031,0.019500017166137695,772
../DataSets\DelayGraph_1136.graphml,1621,2101,3722,0.0025000572204589844,161
../DataSets\DelayGraph_1137.graphml,7243,8788,16031,0.022500038146972656,772
../DataSets\DelayGraph_1138.graphml,208,223,431,0.0,38
../DataSets\DelayGraph_1139.graphml,54,51,105,0.0,10
../DataSets\DelayGraph_1140.graphml,212,210,422,0.0,42
../DataSets\DelayGraph_1141.graphml,101,108,209,0.0,19
../DataSets\DelayGraph_1142.graphml,101,108,209,0.0,19
../DataSets\DelayGraph_1143.graphml,118,123,241,0.0,24
../DataSets\DelayGraph_1144.graphml,118,123,241,0.0,24
../DataSets\DelayGraph_1145.graphml,36,35,71,0.0,6
../DataSets\DelayGraph_1146.graphml,36,35,71,0.0,6
../DataSets\DelayGraph_1147.graphml,8,7,15,0.0,2
../DataSets\DelayGraph_1148.graphml,28,28,56,0.0,8
../DataSets\DelayGraph_1149.graphml,28,28,56,0.0,8
../DataSets\DelayGraph_1150.graphml,233,242,475,0.002499818801879883,40
../DataSets\DelayGraph_1151.graphml,128,132,260,0.0,16
../DataSets\DelayGraph_1152.graphml,128,132,260,0.0,16
../DataSets\DelayGraph_1153.graphml,191,232,423,0.0025000572204589844,9
../DataSets\DelayGraph_1154.graphml,145,154,299,0.002499818801879883,7
../DataSets\DelayGraph_1155.graphml,145,154,299,0.0,7
../DataSets\DelayGraph_1156.graphml,58,58,116,0.0,11
../DataSets\DelayGraph_1157.graphml,152,203,355,0.0,163
../DataSets\DelayGraph_1158.graphml,152,203,355,0.0,110
../DataSets\DelayGraph_1159.graphml,152,203,355,0.0,109
../DataSets\DelayGraph_1160.graphml,51,53,104,0.0,11
../DataSets\DelayGraph_1161.graphml,3,2,5,0.0,1
../DataSets\DelayGraph_1162.graphml,387,419,806,0.0,80
../DataSets\DelayGraph_1163.graphml,730,854,1584,0.0025000572204589844,187
../DataSets\DelayGraph_1164.graphml,730,854,1584,0.0,187
../DataSets\DelayGraph_1165.graphml,90,90,180,0.0,18
../DataSets\DelayGraph_1166.graphml,180,201,381,0.0,54
../DataSets\DelayGraph_1167.graphml,180,201,381,0.0,54
../DataSets\DelayGraph_1168.graphml,3817,5496,9313,0.015000104904174805,4725
../DataSets\DelayGraph_1169.graphml,33018,41898,74916,0.14149999618530273,1155362
../DataSets\DelayGraph_1170.graphml,31815,43635,75450,0.18000006675720215,456596296158
../DataSets\DelayGraph_1171.graphml,33018,41898,74916,0.19000005722045898,1155362
../DataSets\DelayGraph_1172.graphml,1713,1831,3544,0.007500171661376953,1710
../DataSets\DelayGraph_1173.graphml,4452,5196,9648,0.009999990463256836,807616170669868694672
../DataSets\DelayGraph_1174.graphml,867,1123,1990,0.002499818801879883,39994352409384863
../DataSets\DelayGraph_1175.graphml,867,1123,1990,0.002499818801879883,39994352409384863
../DataSets\DelayGraph_1176.graphml,853,1033,1886,0.0,3787047629
../DataSets\DelayGraph_1177.graphml,117,137,254,0.0,152
../DataSets\DelayGraph_1178.graphml,63,71,134,0.0,34
../DataSets\DelayGraph_1179.graphml,696,861,1557,0.0,23578318493
../DataSets\DelayGraph_1180.graphml,790,1043,1833,0.002499818801879883,64178900939427
../DataSets\DelayGraph_1181.graphml,790,1043,1833,0.0,64178900939427
../DataSets\DelayGraph_1182.graphml,4452,5196,9648,0.009999990463256836,807616170669868694672
../DataSets\DelayGraph_1183.graphml,54,57,111,0.0,6
../DataSets\DelayGraph_1184.graphml,943,1007,1950,0.0,510
../DataSets\DelayGraph_1185.graphml,943,1007,1950,0.0,510
../DataSets\DelayGraph_1186.graphml,96,94,190,0.0,4
../DataSets\DelayGraph_1187.graphml,96,94,190,0.0,4
../DataSets\DelayGraph_1188.graphml,37,37,74,0.0,4
../DataSets\DelayGraph_1189.graphml,37,37,74,0.0010001659393310547,4
../DataSets\DelayGraph_1190.graphml,158,165,323,0.0,13
../DataSets\DelayGraph_1191.graphml,201,218,419,0.0,50
../DataSets\DelayGraph_1192.graphml,201,218,419,0.0025000572204589844,50
../DataSets\DelayGraph_1193.graphml,201,218,419,0.0,50
../DataSets\DelayGraph_1194.graphml,189,205,394,0.0,16
../DataSets\DelayGraph_1195.graphml,59,62,121,0.0,5
../DataSets\DelayGraph_1196.graphml,113,129,242,0.0,33
../DataSets\DelayGraph_1197.graphml,113,129,242,0.0010001659393310547,33
../DataSets\DelayGraph_1198.graphml,4,3,7,0.0,1
../DataSets\DelayGraph_1199.graphml,848,945,1793,0.0,170
../DataSets\DelayGraph_1200.graphml,1105,1282,2387,0.0025000572204589844,579
../DataSets\DelayGraph_1201.graphml,1246,1442,2688,0.005000114440917969,305
../DataSets\DelayGraph_1202.graphml,848,945,1793,0.002499818801879883,170
../DataSets\DelayGraph_1203.graphml,268,268,536,0.0,80
../DataSets\DelayGraph_1204.graphml,1346,1882,3228,0.005000114440917969,146
../DataSets\DelayGraph_1205.graphml,1346,1882,3228,0.005000114440917969,146
../DataSets\DelayGraph_1206.graphml,274,301,575,0.0,83
../DataSets\DelayGraph_1207.graphml,152,179,331,0.002499818801879883,139
../DataSets\DelayGraph_1208.graphml,152,179,331,0.0,139
../DataSets\DelayGraph_1209.graphml,20,21,41,0.0,6
../DataSets\DelayGraph_1210.graphml,20,21,41,0.0,6
../DataSets\DelayGraph_1211.graphml,1746,2245,3991,0.0074999332427978516,424
../DataSets\DelayGraph_1212.graphml,1643,2124,3767,0.0034999847412109375,419
../DataSets\DelayGraph_1213.graphml,1401,1862,3263,0.0025000572204589844,506
../DataSets\DelayGraph_1214.graphml,13459,16912,30371,0.03750014305114746,10188
../DataSets\DelayGraph_1215.graphml,13459,16912,30371,0.04250001907348633,10188
../DataSets\DelayGraph_1216.graphml,108,106,214,0.0012500286102294922,14
../DataSets\DelayGraph_1217.graphml,116,135,251,0.0,68
../DataSets\DelayGraph_1218.graphml,428,519,947,0.0012500286102294922,353727
../DataSets\DelayGraph_1219.graphml,1186,1571,2757,0.0012500286102294922,269185820927465307946
../DataSets\DelayGraph_1220.graphml,220,263,483,0.0012500286102294922,1213
../DataSets\DelayGraph_1221.graphml,1234,1549,2783,0.0025000572204589844,92916933112018481418
../DataSets\DelayGraph_1222.graphml,1186,1571,2757,0.002000093460083008,269185820927465307946
../DataSets\DelayGraph_1223.graphml,63,71,134,0.0,13
../DataSets\DelayGraph_1224.graphml,844,1031,1875,0.0012500286102294922,23574354690
../DataSets\DelayGraph_1225.graphml,458,472,930,0.0012497901916503906,100
../DataSets\DelayGraph_1226.graphml,90,89,179,0.0,12
../DataSets\DelayGraph_1227.graphml,135,131,266,0.0,17
../DataSets\DelayGraph_1228.graphml,124,136,260,0.0012500286102294922,18
../DataSets\DelayGraph_1229.graphml,174,207,381,0.0,194
../DataSets\DelayGraph_1230.graphml,226,252,478,0.0,64
../DataSets\DelayGraph_1231.graphml,187,206,393,0.0,52
../DataSets\DelayGraph_1232.graphml,375,448,823,0.0,450
../DataSets\DelayGraph_1233.graphml,79,85,164,0.0012500286102294922,19
../DataSets\DelayGraph_1234.graphml,580,724,1304,0.0012500286102294922,764
../DataSets\DelayGraph_1235.graphml,79,85,164,0.0,19
../DataSets\DelayGraph_1236.graphml,93,95,188,0.0,9
../DataSets\DelayGraph_1237.graphml,93,95,188,0.0,9
../DataSets\DelayGraph_1238.graphml,147,166,313,0.0,39
../DataSets\DelayGraph_1239.graphml,123,135,258,0.0,14
../DataSets\DelayGraph_1240.graphml,90,96,186,0.0,17
../DataSets\DelayGraph_1241.graphml,90,96,186,0.0,17
../DataSets\DelayGraph_1242.graphml,18752,22972,41724,0.04849982261657715,1571361120146360325
../DataSets\DelayGraph_1243.graphml,26,25,51,0.0012500286102294922,7
../DataSets\DelayGraph_1244.graphml,3,2,5,0.0,1
../DataSets\DelayGraph_1245.graphml,3,2,5,0.0,1
../DataSets\DelayGraph_1246.graphml,3,2,5,0.0,1
../DataSets\DelayGraph_1247.graphml,65,60,125,0.0,11
../DataSets\DelayGraph_1248.graphml,65,60,125,0.0,11
../DataSets\DelayGraph_1249.graphml,2918,3679,6597,0.006250143051147461,73754
../DataSets\DelayGraph_1250.graphml,19266,23488,42754,0.04874992370605469,1571361120146360325
../DataSets\DelayGraph_1251.graphml,5095,6224,11319,0.012499809265136719,4016974
../DataSets\DelayGraph_1252.graphml,3727,4624,8351,0.008749961853027344,402718
../DataSets\DelayGraph_1253.graphml,5095,6224,11319,0.011250019073486328,4016974
../DataSets\DelayGraph_1254.graphml,558,697,1255,0.0012500286102294922,313
../DataSets\DelayGraph_1255.graphml,4085,5295,9380,0.009999990463256836,5825
../DataSets\DelayGraph_1256.graphml,4085,5295,9380,0.011250019073486328,5825
../DataSets\DelayGraph_1257.graphml,173,177,350,0.0,24
../DataSets\DelayGraph_1258.graphml,7342,10086,17428,0.026250123977661133,118227
../DataSets\DelayGraph_1259.graphml,7342,10086,17428,0.027499914169311523,118227
../DataSets\DelayGraph_1260.graphml,1862,2009,3871,0.005000114440917969,3106
../DataSets\DelayGraph_1261.graphml,4849,5692,10541,0.009999990463256836,66855557275895341184112
../DataSets\DelayGraph_1262.graphml,867,1123,1990,0.0012500286102294922,39994352409384863
../DataSets\DelayGraph_1263.graphml,867,1123,1990,0.0025000572204589844,39994352409384863
../DataSets\DelayGraph_1264.graphml,117,137,254,0.0,163
../DataSets\DelayGraph_1265.graphml,853,1033,1886,0.0012500286102294922,4509238745
../DataSets\DelayGraph_1266.graphml,644,849,1493,0.0012500286102294922,250698831527
../DataSets\DelayGraph_1267.graphml,61,69,130,0.0,13
../DataSets\DelayGraph_1268.graphml,638,795,1433,0.0012500286102294922,19635556522
../DataSets\DelayGraph_1269.graphml,644,849,1493,0.0012500286102294922,250698831527
../DataSets\DelayGraph_1270.graphml,4849,5692,10541,0.009999990463256836,66855557275895341184112
../DataSets\DelayGraph_1271.graphml,44,44,88,0.0,6
../DataSets\DelayGraph_1272.graphml,115,120,235,0.0,12
../DataSets\DelayGraph_1273.graphml,1020,1322,2342,0.002499818801879883,9718627635480692195
../DataSets\DelayGraph_1274.graphml,1048,1302,2350,0.0012497901916503906,120074564397975826
../DataSets\DelayGraph_1275.graphml,1020,1322,2342,0.0025000572204589844,9718627635480692195
../DataSets\DelayGraph_1276.graphml,141,167,308,0.0,164
../DataSets\DelayGraph_1277.graphml,115,120,235,0.002499818801879883,12
../DataSets\DelayGraph_1278.graphml,64,67,131,0.0,12
../DataSets\DelayGraph_1279.graphml,3586,4212,7798,0.014999866485595703,850
../DataSets\DelayGraph_1280.graphml,3586,4212,7798,0.010000228881835938,850
../DataSets\DelayGraph_1281.graphml,398,435,833,0.0025000572204589844,88
../DataSets\DelayGraph_1282.graphml,444,534,978,0.0,238
../DataSets\DelayGraph_1283.graphml,202,227,429,0.0,61
../DataSets\DelayGraph_1284.graphml,202,227,429,0.0,61
../DataSets\DelayGraph_1285.graphml,372,390,762,0.0,108
../DataSets\DelayGraph_1286.graphml,606,680,1286,0.0025000572204589844,599
../DataSets\DelayGraph_1287.graphml,606,680,1286,0.0,599
../DataSets\DelayGraph_1288.graphml,746,811,1557,0.0,672
../DataSets\DelayGraph_1289.graphml,746,811,1557,0.0025000572204589844,672
../DataSets\DelayGraph_1290.graphml,117,115,232,0.0,4
../DataSets\DelayGraph_1291.graphml,117,115,232,0.0,4
../DataSets\DelayGraph_1292.graphml,94,97,191,0.0,18
../DataSets\DelayGraph_1293.graphml,185,203,388,0.002499818801879883,57
../DataSets\DelayGraph_1294.graphml,185,203,388,0.0,57
../DataSets\DelayGraph_1295.graphml,185,203,388,0.0,57
../DataSets\DelayGraph_1296.graphml,6,5,11,0.0,1
../DataSets\DelayGraph_1297.graphml,14,13,27,0.0,3
../DataSets\DelayGraph_1298.graphml,14,13,27,0.0,3
../DataSets\DelayGraph_1299.graphml,6,5,11,0.0,1
../DataSets\DelayGraph_1300.graphml,517,539,1056,0.0025000572204589844,117
../DataSets\DelayGraph_1301.graphml,82,88,170,0.0025000572204589844,21
../DataSets\DelayGraph_1302.graphml,82,88,170,0.0,21
../DataSets\DelayGraph_1303.graphml,1610,1724,3334,0.0025000572204589844,2676
../DataSets\DelayGraph_1304.graphml,9249,11637,20886,0.027500152587890625,7056
../DataSets\DelayGraph_1305.graphml,9249,11637,20886,0.039999961853027344,7056
../DataSets\DelayGraph_1306.graphml,305,324,629,0.0010001659393310547,66
../DataSets\DelayGraph_1307.graphml,184,224,408,0.0,74
../DataSets\DelayGraph_1308.graphml,184,224,408,0.0,74
../DataSets\DelayGraph_1309.graphml,42,42,84,0.0025000572204589844,6
../DataSets\DelayGraph_1310.graphml,169,198,367,0.0,168
../DataSets\DelayGraph_1311.graphml,169,198,367,0.0,168
../DataSets\DelayGraph_1312.graphml,52,48,100,0.0,8
../DataSets\DelayGraph_1313.graphml,52,48,100,0.0,8
../DataSets\DelayGraph_1314.graphml,150,156,306,0.0025000572204589844,26
../DataSets\DelayGraph_1315.graphml,301,324,625,0.0,60
../DataSets\DelayGraph_1316.graphml,355,442,797,0.0,1400161
../DataSets\DelayGraph_1317.graphml,368,456,824,0.0,585410
../DataSets\DelayGraph_1318.graphml,355,442,797,0.0,1400161
../DataSets\DelayGraph_1319.graphml,110,128,238,0.0,26
../DataSets\DelayGraph_1320.graphml,153,182,335,0.0,87
../DataSets\DelayGraph_1321.graphml,416,520,936,0.0,16158321
../DataSets\DelayGraph_1322.graphml,416,520,936,0.002499818801879883,16158321
../DataSets\DelayGraph_1323.graphml,401,498,899,0.0,3235682
../DataSets\DelayGraph_1324.graphml,124,146,270,0.0,51
../DataSets\DelayGraph_1325.graphml,396,492,888,0.0,1170819
../DataSets\DelayGraph_1326.graphml,383,478,861,0.002499818801879883,2800322
../DataSets\DelayGraph_1327.graphml,383,478,861,0.0025000572204589844,2800322
../DataSets\DelayGraph_1328.graphml,355,442,797,0.0009999275207519531,1400161
../DataSets\DelayGraph_1329.graphml,355,442,797,0.0,1400161
../DataSets\DelayGraph_1330.graphml,110,128,238,0.0,26
../DataSets\DelayGraph_1331.graphml,368,456,824,0.0,585410
../DataSets\DelayGraph_1332.graphml,301,324,625,0.0,60
../DataSets\DelayGraph_1333.graphml,25,26,51,0.0,5
../DataSets\DelayGraph_1334.graphml,25,26,51,0.0,5
../DataSets\DelayGraph_1335.graphml,92,100,192,0.0,14
../DataSets\DelayGraph_1336.graphml,5947,7446,13393,0.019999980926513672,5341
../DataSets\DelayGraph_1337.graphml,161,164,325,0.0,22
../DataSets\DelayGraph_1338.graphml,183,173,356,0.0,32
../DataSets\DelayGraph_1339.graphml,183,173,356,0.0,32
../DataSets\DelayGraph_1340.graphml,2465,3254,5719,0.0074999332427978516,18016
../DataSets\DelayGraph_1341.graphml,2465,3254,5719,0.007500171661376953,18016
../DataSets\DelayGraph_1342.graphml,1263,1496,2759,0.0019998550415039062,416
../DataSets\DelayGraph_1343.graphml,1480,8116,9596,0.005000114440917969,3
../DataSets\DelayGraph_1344.graphml,1263,1496,2759,0.0025000572204589844,416
../DataSets\DelayGraph_1345.graphml,138,177,315,0.0025000572204589844,48
../DataSets\DelayGraph_1346.graphml,92,91,183,0.0,23
../DataSets\DelayGraph_1347.graphml,90,104,194,0.0,32
../DataSets\DelayGraph_1348.graphml,37,37,74,0.0,7
../DataSets\DelayGraph_1349.graphml,30,30,60,0.0,7
../DataSets\DelayGraph_1350.graphml,55,66,121,0.0,33
../DataSets\DelayGraph_1351.graphml,53,67,120,0.0,33
../DataSets\DelayGraph_1352.graphml,304,343,647,0.0025000572204589844,55
../DataSets\DelayGraph_1353.graphml,304,343,647,0.0,55
../DataSets\DelayGraph_1354.graphml,243,266,509,0.0,99
../DataSets\DelayGraph_1355.graphml,243,266,509,0.0025000572204589844,99
../DataSets\DelayGraph_1356.graphml,62,65,127,0.0,8
../DataSets\DelayGraph_1357.graphml,486,594,1080,0.0025000572204589844,90
../DataSets\DelayGraph_1358.graphml,486,594,1080,0.0025000572204589844,90
../DataSets\DelayGraph_1359.graphml,12,9,21,0.0,3
../DataSets\DelayGraph_1360.graphml,12,9,21,0.0025000572204589844,3
../DataSets\DelayGraph_1361.graphml,95,96,191,0.0,18
../DataSets\DelayGraph_1362.graphml,95,96,191,0.002499818801879883,18
../DataSets\DelayGraph_1363.graphml,1957,2139,4096,0.005000114440917969,1441
../DataSets\DelayGraph_1364.graphml,50149,67254,117403,0.36479997634887695,16182056
../DataSets\DelayGraph_1365.graphml,19981,30225,50206,0.09500002861022949,456998949836
../DataSets\DelayGraph_1366.graphml,50149,67254,117403,0.20600008964538574,16182056
../DataSets\DelayGraph_1367.graphml,3236,4899,8135,0.009999990463256836,4752
../DataSets\DelayGraph_1368.graphml,26747,35441,62188,0.1640000343322754,9876189
../DataSets\DelayGraph_1369.graphml,26032,37048,63080,0.14950013160705566,1174106558034
../DataSets\DelayGraph_1370.graphml,26747,35441,62188,0.13499999046325684,9876189
../DataSets\DelayGraph_1371.graphml,1080,1814,2894,0.0025000572204589844,134217883
../DataSets\DelayGraph_1372.graphml,1207,1965,3172,0.0025000572204589844,134218063
../DataSets\DelayGraph_1373.graphml,1207,1965,3172,0.0025000572204589844,134218063
../DataSets\DelayGraph_1374.graphml,62,61,123,0.0,10
../DataSets\DelayGraph_1375.graphml,62,61,123,0.0,10
../DataSets\DelayGraph_1376.graphml,127,123,250,0.0,4
../DataSets\DelayGraph_1377.graphml,127,123,250,0.0,4
../DataSets\DelayGraph_1378.graphml,16,15,31,0.0,2
../DataSets\DelayGraph_1379.graphml,16,15,31,0.0,2
../DataSets\DelayGraph_1380.graphml,335,357,692,0.0,195
../DataSets\DelayGraph_1381.graphml,300,333,633,0.0,705
../DataSets\DelayGraph_1382.graphml,173,225,398,0.0,441
../DataSets\DelayGraph_1383.graphml,173,225,398,0.0,441
../DataSets\DelayGraph_1384.graphml,58,58,116,0.0,11
../DataSets\DelayGraph_1385.graphml,60,61,121,0.0,10
../DataSets\DelayGraph_1386.graphml,1128,1735,2863,0.0025000572204589844,1218
../DataSets\DelayGraph_1387.graphml,1128,1735,2863,0.0025000572204589844,1218
../DataSets\DelayGraph_1388.graphml,104,106,210,0.0,27
../DataSets\DelayGraph_1389.graphml,128,132,260,0.0,33
../DataSets\DelayGraph_1390.graphml,104,106,210,0.0,27
../DataSets\DelayGraph_1391.graphml,79,81,160,0.0,14
../DataSets\DelayGraph_1392.graphml,1002,1086,2088,0.0025000572204589844,3008
../DataSets\DelayGraph_1393.graphml,1002,1086,2088,0.0025000572204589844,3008
../DataSets\DelayGraph_1394.graphml,36,34,70,0.0,10
../DataSets\DelayGraph_1395.graphml,36,34,70,0.0,10
../DataSets\DelayGraph_1396.graphml,237,283,520,0.0,75
../DataSets\DelayGraph_1397.graphml,237,283,520,0.0025000572204589844,93
../DataSets\DelayGraph_1398.graphml,237,283,520,0.0,93
../DataSets\DelayGraph_1399.graphml,495,538,1033,0.0025000572204589844,122
../DataSets\DelayGraph_1400.graphml,495,538,1033,0.0,122
../DataSets\DelayGraph_1401.graphml,63,65,128,0.0,13
../DataSets\DelayGraph_1402.graphml,193,228,421,0.0025000572204589844,70
../DataSets\DelayGraph_1403.graphml,193,228,421,0.0025000572204589844,70
../DataSets\DelayGraph_1404.graphml,84,86,170,0.0,14
../DataSets\DelayGraph_1405.graphml,1542,1804,3346,0.004999876022338867,590
../DataSets\DelayGraph_1406.graphml,34285,52635,86920,0.3190000057220459,5011337102401836053792582472713345902569740610
../DataSets\DelayGraph_1407.graphml,17364,20908,38272,0.10599994659423828,7768912356733746474362594233318940861574297067703898693054681187556622881898613890460004433809198602697770617004469288633419013
../DataSets\DelayGraph_1408.graphml,17364,20908,38272,0.13299989700317383,7768912356733746474362594233318940861574297067703898693054681187556622881898613890460004433809198602697770617004469288633419013
../DataSets\DelayGraph_1409.graphml,19,19,38,0.0025000572204589844,4
../DataSets\DelayGraph_1410.graphml,19,19,38,0.0,4
../DataSets\DelayGraph_1411.graphml,224,231,455,0.0,38
../DataSets\DelayGraph_1412.graphml,208,223,431,0.0,39
../DataSets\DelayGraph_1413.graphml,118,123,241,0.0025000572204589844,24
../DataSets\DelayGraph_1414.graphml,16,14,30,0.0,4
../DataSets\DelayGraph_1415.graphml,16,14,30,0.0,4
../DataSets\DelayGraph_1416.graphml,2525,3428,5953,0.004999876022338867,25948
../DataSets\DelayGraph_1417.graphml,2525,3428,5953,0.004999876022338867,25948
../DataSets\DelayGraph_1418.graphml,62,65,127,0.0,21
../DataSets\DelayGraph_1419.graphml,62,65,127,0.0,36
../DataSets\DelayGraph_1420.graphml,101,116,217,0.0,112
../DataSets\DelayGraph_1421.graphml,43,33,76,0.0,12
../DataSets\DelayGraph_1422.graphml,43,33,76,0.0,12
../DataSets\DelayGraph_1423.graphml,43,33,76,0.0,12
../DataSets\DelayGraph_1424.graphml,14,14,28,0.0,4
../DataSets\DelayGraph_1425.graphml,26,28,54,0.0,11
../DataSets\DelayGraph_1426.graphml,76,80,156,0.0,21
../DataSets\DelayGraph_1427.graphml,76,80,156,0.0,21
../DataSets\DelayGraph_1428.graphml,138,149,287,0.0,31
../DataSets\DelayGraph_1429.graphml,138,149,287,0.0,31
../DataSets\DelayGraph_1430.graphml,138,149,287,0.0,31
../DataSets\DelayGraph_1431.graphml,193,204,397,0.0,6
../DataSets\DelayGraph_1432.graphml,238,250,488,0.002499818801879883,4
../DataSets\DelayGraph_1433.graphml,330,360,690,0.0,23
../DataSets\DelayGraph_1434.graphml,392,416,808,0.0009999275207519531,25
../DataSets\DelayGraph_1435.graphml,347,370,717,0.0025000572204589844,27
../DataSets\DelayGraph_1436.graphml,285,314,599,0.0,24
../DataSets\DelayGraph_1437.graphml,220,263,483,0.0,1439
../DataSets\DelayGraph_1438.graphml,116,135,251,0.0,81
../DataSets\DelayGraph_1439.graphml,116,135,251,0.0025000572204589844,74
../DataSets\DelayGraph_1440.graphml,1762,2339,4101,0.004999876022338867,1156144297430375889328011717978
../DataSets\DelayGraph_1441.graphml,63,71,134,0.0,12
../DataSets\DelayGraph_1442.graphml,1762,2339,4101,0.005000114440917969,1156144297430375889328011717978
../DataSets\DelayGraph_1443.graphml,844,1031,1875,0.002499818801879883,23336485194
../DataSets\DelayGraph_1444.graphml,428,519,947,0.0,458493
../DataSets\DelayGraph_1445.graphml,1458,1805,3263,0.005000114440917969,123549457782095196179
../DataSets\DelayGraph_1446.graphml,238,250,488,0.0,4
../DataSets\DelayGraph_1447.graphml,685,738,1423,0.0,202
../DataSets\DelayGraph_1448.graphml,4272,4978,9250,0.015000104904174805,219
../DataSets\DelayGraph_1449.graphml,3469,4210,7679,0.007500171661376953,8
../DataSets\DelayGraph_1450.graphml,3469,4210,7679,0.009999990463256836,8
../DataSets\DelayGraph_1451.graphml,357,385,742,0.0,76
../DataSets\DelayGraph_1452.graphml,18,17,35,0.0,2
../DataSets\DelayGraph_1453.graphml,18,17,35,0.0,2
../DataSets\DelayGraph_1454.graphml,36,31,67,0.0,8
../DataSets\DelayGraph_1455.graphml,36,31,67,0.0,8
../DataSets\DelayGraph_1456.graphml,20,19,39,0.0,2
../DataSets\DelayGraph_1457.graphml,20,19,39,0.0,2
../DataSets\DelayGraph_1458.graphml,112,121,233,0.0,30
../DataSets\DelayGraph_1459.graphml,21226,24729,45955,0.18000006675720215,598247370877531439875842
../DataSets\DelayGraph_1460.graphml,21226,24729,45955,0.1099998950958252,598247370877531439875842
../DataSets\DelayGraph_1461.graphml,60,50,110,0.0025000572204589844,10
../DataSets\DelayGraph_1462.graphml,60,50,110,0.0,10
../DataSets\DelayGraph_1463.graphml,44,44,88,0.0,7
../DataSets\DelayGraph_1464.graphml,23,21,44,0.0,3
../DataSets\DelayGraph_1465.graphml,110,126,236,0.0,33
../DataSets\DelayGraph_1466.graphml,110,126,236,0.0,33
../DataSets\DelayGraph_1467.graphml,88,94,182,0.0,24
../DataSets\DelayGraph_1468.graphml,237,257,494,0.0,54
../DataSets\DelayGraph_1469.graphml,235,300,535,0.0025000572204589844,150
../DataSets\DelayGraph_1470.graphml,235,300,535,0.0,150
../DataSets\DelayGraph_1471.graphml,237,257,494,0.0,54
../DataSets\DelayGraph_1472.graphml,235,300,535,0.0025000572204589844,150
../DataSets\DelayGraph_1473.graphml,235,300,535,0.0,150
../DataSets\DelayGraph_1474.graphml,222,235,457,0.0,54
../DataSets\DelayGraph_1475.graphml,215,280,495,0.0,150
../DataSets\DelayGraph_1476.graphml,215,280,495,0.0,150
../DataSets\DelayGraph_1477.graphml,3285,3603,6888,0.009999990463256836,1257
../DataSets\DelayGraph_1478.graphml,2159,2836,4995,0.0074999332427978516,104480
../DataSets\DelayGraph_1479.graphml,2159,2836,4995,0.005000114440917969,104480
../DataSets\DelayGraph_1480.graphml,2637,2821,5458,0.004999876022338867,1012
../DataSets\DelayGraph_1481.graphml,19124,29839,48963,0.04999995231628418,759783736116
../DataSets\DelayGraph_1482.graphml,19124,29839,48963,0.0709998607635498,759783736116
../DataSets\DelayGraph_1483.graphml,11,9,20,0.0,2
../DataSets\DelayGraph_1484.graphml,13,11,24,0.0,3
../DataSets\DelayGraph_1485.graphml,2902,3663,6565,0.004999876022338867,73754
../DataSets\DelayGraph_1486.graphml,18754,22976,41730,0.04500007629394531,1571361120146360325
../DataSets\DelayGraph_1487.graphml,5031,6160,11191,0.012499809265136719,4016974
../DataSets\DelayGraph_1488.graphml,3695,4592,8287,0.009999990463256836,402718
../DataSets\DelayGraph_1489.graphml,3695,4592,8287,0.0074999332427978516,402718
../DataSets\DelayGraph_1490.graphml,8,7,15,0.0,2
../DataSets\DelayGraph_1491.graphml,16,15,31,0.0,4
../DataSets\DelayGraph_1492.graphml,3821,4147,7968,0.009999990463256836,299
../DataSets\DelayGraph_1493.graphml,6870,8722,15592,0.02500009536743164,516
../DataSets\DelayGraph_1494.graphml,1403,1864,3267,0.004999876022338867,506
../DataSets\DelayGraph_1495.graphml,26393,33302,59695,0.1575000286102295,310168
../DataSets\DelayGraph_1496.graphml,26393,33302,59695,0.10000014305114746,310168
../DataSets\DelayGraph_1497.graphml,160,159,319,0.0009999275207519531,4
../DataSets\DelayGraph_1498.graphml,61,69,130,0.0,12
../DataSets\DelayGraph_1499.graphml,320,395,715,0.0,271787
../DataSets\DelayGraph_1500.graphml,320,417,737,0.0,956258
../DataSets\DelayGraph_1501.graphml,218,261,479,0.0025000572204589844,1277
../DataSets\DelayGraph_1502.graphml,320,417,737,0.0,956258
../DataSets\DelayGraph_1503.graphml,160,159,319,0.0,4
../DataSets\DelayGraph_1504.graphml,60,56,116,0.0,9
../DataSets\DelayGraph_1505.graphml,706,796,1502,0.0025000572204589844,285
../DataSets\DelayGraph_1506.graphml,3634,5860,9494,0.014999866485595703,122808
../DataSets\DelayGraph_1507.graphml,3634,5860,9494,0.009999990463256836,122808
../DataSets\DelayGraph_1508.graphml,51,58,109,0.0,3
../DataSets\DelayGraph_1509.graphml,51,58,109,0.0,3
../DataSets\DelayGraph_1510.graphml,8757,149244,158001,0.09500002861022949,173386909405084918873926696328911700846860726037632518205625322246352042671683369454667789508885
../DataSets\DelayGraph_1511.graphml,53,57,110,0.0,13
../DataSets\DelayGraph_1512.graphml,53,57,110,0.0,13
../DataSets\DelayGraph_1513.graphml,46,44,90,0.0,6
../DataSets\DelayGraph_1514.graphml,84,88,172,0.0,24
../DataSets\DelayGraph_1515.graphml,13,13,26,0.0,4
../DataSets\DelayGraph_1516.graphml,44,45,89,0.0,15
../DataSets\DelayGraph_1517.graphml,34,31,65,0.0,6
../DataSets\DelayGraph_1518.graphml,34,31,65,0.0,6
../DataSets\DelayGraph_1519.graphml,111,119,230,0.0,22
../DataSets\DelayGraph_1520.graphml,111,119,230,0.0,22
../DataSets\DelayGraph_1521.graphml,90,95,185,0.0,13
../DataSets\DelayGraph_1522.graphml,90,95,185,0.0,13
../DataSets\DelayGraph_1523.graphml,90,95,185,0.0,13
../DataSets\DelayGraph_1524.graphml,47,55,102,0.002499818801879883,22
../DataSets\DelayGraph_1525.graphml,47,55,102,0.0,22
../DataSets\DelayGraph_1526.graphml,132,135,267,0.0,15
../DataSets\DelayGraph_1527.graphml,198,222,420,0.0,60
../DataSets\DelayGraph_1528.graphml,198,222,420,0.0,60
../DataSets\DelayGraph_1529.graphml,5951,7895,13846,0.03250002861022949,6002
../DataSets\DelayGraph_1530.graphml,57077,77591,134668,0.5349998474121094,4471466940
../DataSets\DelayGraph_1531.graphml,57077,77591,134668,0.3055000305175781,4472169730
../DataSets\DelayGraph_1532.graphml,1599,2075,3674,0.0074999332427978516,161
../DataSets\DelayGraph_1533.graphml,6798,8786,15584,0.022500038146972656,772
../DataSets\DelayGraph_1534.graphml,2419,3108,5527,0.004999876022338867,1357
../DataSets\DelayGraph_1535.graphml,1873,2422,4295,0.0025000572204589844,693
../DataSets\DelayGraph_1536.graphml,1873,2422,4295,0.0025000572204589844,693
../DataSets\DelayGraph_1537.graphml,36,37,73,0.0009999275207519531,7
../DataSets\DelayGraph_1538.graphml,233,249,482,0.0,36
../DataSets\DelayGraph_1539.graphml,130,153,283,0.0,58
../DataSets\DelayGraph_1540.graphml,130,153,283,0.0,58
../DataSets\DelayGraph_1541.graphml,89,94,183,0.0,34
../DataSets\DelayGraph_1542.graphml,943,1007,1950,0.0025000572204589844,510
../DataSets\DelayGraph_1543.graphml,943,1007,1950,0.002499818801879883,510
../DataSets\DelayGraph_1544.graphml,43,42,85,0.0,7
../DataSets\DelayGraph_1545.graphml,52,50,102,0.0,7
../DataSets\DelayGraph_1546.graphml,107,113,220,0.0,20
../DataSets\DelayGraph_1547.graphml,107,113,220,0.0,20
../DataSets\DelayGraph_1548.graphml,107,113,220,0.0,20
../DataSets\DelayGraph_1549.graphml,1277,1445,2722,0.0025000572204589844,888948
../DataSets\DelayGraph_1550.graphml,893,1157,2050,0.0,119983057228155962
../DataSets\DelayGraph_1551.graphml,274,327,601,0.0,9552
../DataSets\DelayGraph_1552.graphml,482,579,1061,0.0025000572204589844,680691
../DataSets\DelayGraph_1553.graphml,170,201,371,0.0,544
../DataSets\DelayGraph_1554.graphml,898,1083,1981,0.0025000572204589844,4103664181
../DataSets\DelayGraph_1555.graphml,118,138,256,0.0,173
../DataSets\DelayGraph_1556.graphml,893,1157,2050,0.0,119983057228155962
../DataSets\DelayGraph_1557.graphml,113,133,246,0.0,71
../DataSets\DelayGraph_1558.graphml,572,753,1325,0.002499818801879883,15668676769
../DataSets\DelayGraph_1559.graphml,217,261,478,0.0,1677
../DataSets\DelayGraph_1560.graphml,572,753,1325,0.0,15668676769
../DataSets\DelayGraph_1561.graphml,425,517,942,0.0,305366
../DataSets\DelayGraph_1562.graphml,61,69,130,0.0,13
../DataSets\DelayGraph_1563.graphml,1277,1445,2722,0.0025000572204589844,888948
../DataSets\DelayGraph_1564.graphml,71,68,139,0.0,22
../DataSets\DelayGraph_1565.graphml,71,68,139,0.0,13
../DataSets\DelayGraph_1566.graphml,71,68,139,0.0,13
../DataSets\DelayGraph_1567.graphml,49,50,99,0.0,11
../DataSets\DelayGraph_1568.graphml,48,50,98,0.0,12
../DataSets\DelayGraph_1569.graphml,48,50,98,0.0,12
../DataSets\DelayGraph_1570.graphml,205,213,418,0.0,48
../DataSets\DelayGraph_1571.graphml,204,222,426,0.002499818801879883,58
../DataSets\DelayGraph_1572.graphml,204,222,426,0.0,58
../DataSets\DelayGraph_1573.graphml,344,344,688,0.0,63
../DataSets\DelayGraph_1574.graphml,344,344,688,0.0025000572204589844,63
../DataSets\DelayGraph_1575.graphml,639,718,1357,0.0025000572204589844,173
../DataSets\DelayGraph_1576.graphml,1328,1617,2945,0.003000020980834961,600
../DataSets\DelayGraph_1577.graphml,1328,1617,2945,0.002499818801879883,600
../DataSets\DelayGraph_1578.graphml,299,338,637,0.0,85
../DataSets\DelayGraph_1579.graphml,299,338,637,0.0,91
../DataSets\DelayGraph_1580.graphml,299,338,637,0.0,73
../DataSets\DelayGraph_1581.graphml,518,556,1074,0.0025000572204589844,152
../DataSets\DelayGraph_1582.graphml,500,642,1142,0.0,404
../DataSets\DelayGraph_1583.graphml,500,642,1142,0.0,404
../DataSets\DelayGraph_1584.graphml,420,470,890,0.0025000572204589844,404
../DataSets\DelayGraph_1585.graphml,2460,2733,5193,0.004999876022338867,2401
../DataSets\DelayGraph_1586.graphml,754,862,1616,0.002499818801879883,1885
../DataSets\DelayGraph_1587.graphml,1706,1932,3638,0.004999876022338867,5321
../DataSets\DelayGraph_1588.graphml,849,954,1803,0.0025000572204589844,1512
../DataSets\DelayGraph_1589.graphml,1753,2016,3769,0.004999876022338867,19188
../DataSets\DelayGraph_1590.graphml,2341,2611,4952,0.005000114440917969,6806
../DataSets\DelayGraph_1591.graphml,2341,2611,4952,0.004999876022338867,6806
../DataSets\DelayGraph_1592.graphml,1542,1804,3346,0.002499818801879883,590
../DataSets\DelayGraph_1593.graphml,34285,52635,86920,0.18799996376037598,5011337102401836053792582472713345902569740610
../DataSets\DelayGraph_1594.graphml,17364,20908,38272,0.09500002861022949,7768912356733746474362594233318940861574297067703898693054681187556622881898613890460004433809198602697770617004469288633419013
../DataSets\DelayGraph_1595.graphml,17364,20908,38272,0.09749984741210938,7768912356733746474362594233318940861574297067703898693054681187556622881898613890460004433809198602697770617004469288633419013
../DataSets\DelayGraph_1596.graphml,3469,4210,7679,0.012499809265136719,8
../DataSets\DelayGraph_1597.graphml,6,3,9,0.0,3
../DataSets\DelayGraph_1598.graphml,6,3,9,0.0,3
../DataSets\DelayGraph_1599.graphml,428,519,947,0.0,364809
../DataSets\DelayGraph_1600.graphml,116,135,251,0.0,92
../DataSets\DelayGraph_1601.graphml,1234,1549,2783,0.0025000572204589844,92916933112018481418
../DataSets\DelayGraph_1602.graphml,220,263,483,0.0,1577
../DataSets\DelayGraph_1603.graphml,844,1031,1875,0.0,27610007971
../DataSets\DelayGraph_1604.graphml,63,71,134,0.0,12
../DataSets\DelayGraph_1605.graphml,1186,1571,2757,0.002499818801879883,269185820927465307946
../DataSets\DelayGraph_1606.graphml,1186,1571,2757,0.002499818801879883,269185820927465307946
../DataSets\DelayGraph_1607.graphml,492,505,997,0.0,108
../DataSets\DelayGraph_1608.graphml,34,31,65,0.0,6
../DataSets\DelayGraph_1609.graphml,34,31,65,0.0,6
../DataSets\DelayGraph_1610.graphml,477,495,972,0.0,92
../DataSets\DelayGraph_1611.graphml,477,495,972,0.0,92
../DataSets\DelayGraph_1612.graphml,2013,2603,4616,0.005000114440917969,2646
../DataSets\DelayGraph_1613.graphml,3672,4821,8493,0.0074999332427978516,8385
../DataSets\DelayGraph_1614.graphml,3672,4821,8493,0.009999990463256836,8385
../DataSets\DelayGraph_1615.graphml,118,119,237,0.0,15
../DataSets\DelayGraph_1616.graphml,1684,1905,3589,0.0074999332427978516,284
../DataSets\DelayGraph_1617.graphml,1684,1905,3589,0.005000114440917969,284
../DataSets\DelayGraph_1618.graphml,35,34,69,0.0,8
../DataSets\DelayGraph_1619.graphml,11,10,21,0.0,1
../DataSets\DelayGraph_1620.graphml,11,10,21,0.0,1
../DataSets\DelayGraph_1621.graphml,746,811,1557,0.0025000572204589844,672
../DataSets\DelayGraph_1622.graphml,746,811,1557,0.0025000572204589844,672
../DataSets\DelayGraph_1623.graphml,192,208,400,0.0,34
../DataSets\DelayGraph_1624.graphml,90,96,186,0.0,24
../DataSets\DelayGraph_1625.graphml,90,96,186,0.0,24
../DataSets\DelayGraph_1626.graphml,290,308,598,0.0025000572204589844,65
../DataSets\DelayGraph_1627.graphml,2384,3224,5608,0.004999876022338867,726
../DataSets\DelayGraph_1628.graphml,2384,3224,5608,0.004999876022338867,726
../DataSets\DelayGraph_1629.graphml,221,237,458,0.0,83
../DataSets\DelayGraph_1630.graphml,368,397,765,0.0,135
../DataSets\DelayGraph_1631.graphml,618,795,1413,0.002499818801879883,1128846449413
../DataSets\DelayGraph_1632.graphml,624,765,1389,0.0,4665420159
../DataSets\DelayGraph_1633.graphml,126,147,273,0.0025000572204589844,278
../DataSets\DelayGraph_1634.graphml,618,795,1413,0.0,1128846449413
../DataSets\DelayGraph_1635.graphml,368,397,765,0.0,135
../DataSets\DelayGraph_1636.graphml,49,52,101,0.0,10
../DataSets\DelayGraph_1637.graphml,54,61,115,0.0,36
../DataSets\DelayGraph_1638.graphml,54,61,115,0.0,36
../DataSets\DelayGraph_1639.graphml,3511,4480,7991,0.0074999332427978516,2685
../DataSets\DelayGraph_1640.graphml,123,124,247,0.0,92
../DataSets\DelayGraph_1641.graphml,123,124,247,0.0,92
../DataSets\DelayGraph_1642.graphml,706,796,1502,0.0025000572204589844,285
../DataSets\DelayGraph_1643.graphml,3634,5860,9494,0.009999990463256836,122808
../DataSets\DelayGraph_1644.graphml,3634,5860,9494,0.009999990463256836,122808
../DataSets\DelayGraph_1645.graphml,21,22,43,0.0,4
../DataSets\DelayGraph_1646.graphml,27,28,55,0.0,5
../DataSets\DelayGraph_1647.graphml,48,47,95,0.0,8
../DataSets\DelayGraph_1648.graphml,48,47,95,0.0,8
../DataSets\DelayGraph_1649.graphml,24,26,50,0.0,4
../DataSets\DelayGraph_1650.graphml,50,50,100,0.0,8
../DataSets\DelayGraph_1651.graphml,347,399,746,0.0025000572204589844,111
../DataSets\DelayGraph_1652.graphml,347,399,746,0.0,111
../DataSets\DelayGraph_1653.graphml,347,399,746,0.0,111
../DataSets\DelayGraph_1654.graphml,813,1138,1951,0.0025000572204589844,77
../DataSets\DelayGraph_1655.graphml,813,1138,1951,0.0,77
../DataSets\DelayGraph_1656.graphml,4949,6059,11008,0.009999990463256836,119015
../DataSets\DelayGraph_1657.graphml,6411,8393,14804,0.019999980926513672,89193
../DataSets\DelayGraph_1658.graphml,4949,6059,11008,0.013000011444091797,116135
../DataSets\DelayGraph_1659.graphml,18560,25497,44057,0.04500007629394531,1080000
../DataSets\DelayGraph_1660.graphml,4949,6059,11008,0.01250004768371582,116135
../DataSets\DelayGraph_1661.graphml,13,13,26,0.0,4
../DataSets\DelayGraph_1662.graphml,38,38,76,0.0,7
../DataSets\DelayGraph_1663.graphml,43,45,88,0.0,15
../DataSets\DelayGraph_1664.graphml,69,70,139,0.0,10
../DataSets\DelayGraph_1665.graphml,155,183,338,0.0,44
../DataSets\DelayGraph_1666.graphml,155,183,338,0.0,44
../DataSets\DelayGraph_1667.graphml,27,22,49,0.0,5
../DataSets\DelayGraph_1668.graphml,27,22,49,0.0,5
../DataSets\DelayGraph_1669.graphml,27,22,49,0.0,5
../DataSets\DelayGraph_1670.graphml,3486,5146,8632,0.009999990463256836,4690
../DataSets\DelayGraph_1671.graphml,24858,33230,58088,0.1164999008178711,11317610
../DataSets\DelayGraph_1672.graphml,23755,34339,58094,0.11750006675720215,1500247259306
../DataSets\DelayGraph_1673.graphml,24858,33230,58088,0.13249993324279785,11317610
../DataSets\DelayGraph_1674.graphml,3845,5500,9345,0.01250004768371582,4847
../DataSets\DelayGraph_1675.graphml,30262,39226,69488,0.25,332978
../DataSets\DelayGraph_1676.graphml,29797,53868,83665,0.15250015258789062,7764
../DataSets\DelayGraph_1677.graphml,30262,39226,69488,0.2950000762939453,332978
../DataSets\DelayGraph_1678.graphml,74,74,148,0.0025000572204589844,5
../DataSets\DelayGraph_1679.graphml,230,232,462,0.0,8
../DataSets\DelayGraph_1680.graphml,1762,2339,4101,0.004999876022338867,1156144297430375889328011717978
../DataSets\DelayGraph_1681.graphml,1762,2339,4101,0.005000114440917969,1156144297430375889328011717978
../DataSets\DelayGraph_1682.graphml,63,71,134,0.0,12
../DataSets\DelayGraph_1683.graphml,1458,1805,3263,0.005500078201293945,81966037666021196477
../DataSets\DelayGraph_1684.graphml,230,232,462,0.0,8
../DataSets\DelayGraph_1685.graphml,611,629,1240,0.0,108
../DataSets\DelayGraph_1686.graphml,845,919,1764,0.0025000572204589844,599
../DataSets\DelayGraph_1687.graphml,845,919,1764,0.0025000572204589844,599
../DataSets\DelayGraph_1688.graphml,6,5,11,0.0,1
../DataSets\DelayGraph_1689.graphml,6,5,11,0.0,1
../DataSets\DelayGraph_1690.graphml,16,15,31,0.0,2
../DataSets\DelayGraph_1691.graphml,16,15,31,0.0,2
../DataSets\DelayGraph_1692.graphml,91,93,184,0.0,14
../DataSets\DelayGraph_1693.graphml,7,7,14,0.0,2
../DataSets\DelayGraph_1694.graphml,109,112,221,0.0,16
../DataSets\DelayGraph_1695.graphml,393,495,888,0.0,255
../DataSets\DelayGraph_1696.graphml,393,495,888,0.0025000572204589844,255
../DataSets\DelayGraph_1697.graphml,6,5,11,0.0,1
../DataSets\DelayGraph_1698.graphml,66,69,135,0.0,17
../DataSets\DelayGraph_1699.graphml,66,69,135,0.0,17
../DataSets\DelayGraph_1700.graphml,66,69,135,0.0,17
../DataSets\DelayGraph_1701.graphml,78,82,160,0.0,14
../DataSets\DelayGraph_1702.graphml,808,892,1700,0.0025000572204589844,2260
../DataSets\DelayGraph_1703.graphml,808,892,1700,0.0025000572204589844,2260
../DataSets\DelayGraph_1704.graphml,98,93,191,0.0,17
../DataSets\DelayGraph_1705.graphml,1366,18392,19758,0.009999990463256836,5
../DataSets\DelayGraph_1706.graphml,1366,18392,19758,0.007500171661376953,5
../DataSets\DelayGraph_1707.graphml,57,58,115,0.0009999275207519531,15
../DataSets\DelayGraph_1708.graphml,110,119,229,0.0,42
../DataSets\DelayGraph_1709.graphml,110,119,229,0.0,42
../DataSets\DelayGraph_1710.graphml,382,410,792,0.0,86
../DataSets\DelayGraph_1711.graphml,348,442,790,0.0,220
../DataSets\DelayGraph_1712.graphml,348,442,790,0.0,220
../DataSets\DelayGraph_1713.graphml,200,216,416,0.0,46
../DataSets\DelayGraph_1714.graphml,346,394,740,0.0,120
../DataSets\DelayGraph_1715.graphml,346,394,740,0.0,120
../DataSets\DelayGraph_1716.graphml,857,1020,1877,0.0025000572204589844,430
../DataSets\DelayGraph_1717.graphml,218,236,454,0.0,62
../DataSets\DelayGraph_1718.graphml,218,236,454,0.0,62
../DataSets\DelayGraph_1719.graphml,202,213,415,0.0,49
../DataSets\DelayGraph_1720.graphml,471,542,1013,0.0025000572204589844,242208
../DataSets\DelayGraph_1721.graphml,126,147,273,0.0,31527
../DataSets\DelayGraph_1722.graphml,624,765,1389,0.0,4776989925
../DataSets\DelayGraph_1723.graphml,618,795,1413,0.0,1128846449413
../DataSets\DelayGraph_1724.graphml,618,795,1413,0.0025000572204589844,1128846449413
../DataSets\DelayGraph_1725.graphml,471,542,1013,0.0025000572204589844,242208
../DataSets\DelayGraph_1726.graphml,80,82,162,0.0,18
../DataSets\DelayGraph_1727.graphml,80,82,162,0.0,18
../DataSets\DelayGraph_1728.graphml,80,82,162,0.0,26
../DataSets\DelayGraph_1729.graphml,23,23,46,0.0,5
../DataSets\DelayGraph_1730.graphml,20,19,39,0.0,7
../DataSets\DelayGraph_1731.graphml,20,19,39,0.0,7
../DataSets\DelayGraph_1732.graphml,54,51,105,0.0,10
../DataSets\DelayGraph_1733.graphml,137,133,270,0.0,19
../DataSets\DelayGraph_1734.graphml,134,142,276,0.0,34
../DataSets\DelayGraph_1735.graphml,16,14,30,0.0,4
../DataSets\DelayGraph_1736.graphml,16,14,30,0.0,4
../DataSets\DelayGraph_1737.graphml,188,199,387,0.0,14
../DataSets\DelayGraph_1738.graphml,84,80,164,0.0,17
../DataSets\DelayGraph_1739.graphml,84,80,164,0.0,17
../DataSets\DelayGraph_1740.graphml,45,46,91,0.0,9
../DataSets\DelayGraph_1741.graphml,169,195,364,0.0,184
../DataSets\DelayGraph_1742.graphml,278,312,590,0.0,96
../DataSets\DelayGraph_1743.graphml,212,235,447,0.0,76
../DataSets\DelayGraph_1744.graphml,365,424,789,0.0,446
../DataSets\DelayGraph_1745.graphml,93,101,194,0.0,27
../DataSets\DelayGraph_1746.graphml,560,676,1236,0.0025000572204589844,724
../DataSets\DelayGraph_1747.graphml,212,235,447,0.0,76
../DataSets\DelayGraph_1748.graphml,3821,4147,7968,0.009999990463256836,300
../DataSets\DelayGraph_1749.graphml,65,66,131,0.0,12
../DataSets\DelayGraph_1750.graphml,65,66,131,0.0,12
../DataSets\DelayGraph_1751.graphml,88,94,182,0.0,24
../DataSets\DelayGraph_1752.graphml,5031,6160,11191,0.012499809265136719,4016974
../DataSets\DelayGraph_1753.graphml,37,38,75,0.0,13
../DataSets\DelayGraph_1754.graphml,42,53,95,0.0,29
../DataSets\DelayGraph_1755.graphml,42,53,95,0.0,29
../DataSets\DelayGraph_1756.graphml,567,648,1215,0.002499818801879883,123
../DataSets\DelayGraph_1757.graphml,3073,4470,7543,0.007500171661376953,113244372
../DataSets\DelayGraph_1758.graphml,3073,4470,7543,0.009999990463256836,113244372
../DataSets\DelayGraph_1759.graphml,146,158,304,0.0,36
../DataSets\DelayGraph_1760.graphml,146,158,304,0.0,36
../DataSets\DelayGraph_1761.graphml,146,158,304,0.0,36
../DataSets\DelayGraph_1762.graphml,69,76,145,0.0,20
../DataSets\DelayGraph_1763.graphml,69,76,145,0.0,20
../DataSets\DelayGraph_1764.graphml,6508,8652,15160,0.02700018882751465,5689
../DataSets\DelayGraph_1765.graphml,19978,73387,93365,0.07249999046325684,4031144805023446906256364282168451
../DataSets\DelayGraph_1766.graphml,15305,19972,35277,0.059999942779541016,199153661576965724110155251314993
../DataSets\DelayGraph_1767.graphml,15305,19972,35277,0.05749988555908203,199153661576965724110155251314993
../DataSets\DelayGraph_1768.graphml,192,201,393,0.0025000572204589844,40
../DataSets\DelayGraph_1769.graphml,192,201,393,0.0,40
../DataSets\DelayGraph_1770.graphml,76,80,156,0.0,9
../DataSets\DelayGraph_1771.graphml,141,167,308,0.0,164
../DataSets\DelayGraph_1772.graphml,708,914,1622,0.0,18287312486687
../DataSets\DelayGraph_1773.graphml,141,167,308,0.0,165
../DataSets\DelayGraph_1774.graphml,76,80,156,0.0,9
../DataSets\DelayGraph_1775.graphml,61,60,121,0.0,12
../DataSets\DelayGraph_1776.graphml,173,186,359,0.0,30
../DataSets\DelayGraph_1777.graphml,139,149,288,0.0,16
../DataSets\DelayGraph_1778.graphml,126,147,273,0.0,389
../DataSets\DelayGraph_1779.graphml,126,147,273,0.0,389
../DataSets\DelayGraph_1780.graphml,1060,1373,2433,0.0019998550415039062,145779414532210395240
../DataSets\DelayGraph_1781.graphml,139,149,288,0.0,16
../DataSets\DelayGraph_1782.graphml,17,15,32,0.0,4
../DataSets\DelayGraph_1783.graphml,648,651,1299,0.0009999275207519531,15
../DataSets\DelayGraph_1784.graphml,7630,7674,15304,0.017499923706054688,137
../DataSets\DelayGraph_1785.graphml,7630,7674,15304,0.017499923706054688,137
../DataSets\DelayGraph_1786.graphml,921,985,1906,0.0025000572204589844,510
../DataSets\DelayGraph_1787.graphml,921,985,1906,0.0,510
../DataSets\DelayGraph_1788.graphml,501,550,1051,0.0,42
../DataSets\DelayGraph_1789.graphml,98,101,199,0.0025000572204589844,8
../DataSets\DelayGraph_1790.graphml,136,155,291,0.0,207
../DataSets\DelayGraph_1791.graphml,1001,1274,2275,0.0025000572204589844,359949171684469333
../DataSets\DelayGraph_1792.graphml,1030,1267,2297,0.0025000572204589844,119983057228155964
../DataSets\DelayGraph_1793.graphml,136,157,293,0.0,152
../DataSets\DelayGraph_1794.graphml,1001,1274,2275,0.0025000572204589844,359949171684469333
../DataSets\DelayGraph_1795.graphml,136,155,291,0.0,207
../DataSets\DelayGraph_1796.graphml,109,108,217,0.0,9
../DataSets\DelayGraph_1797.graphml,1001,1274,2275,0.0019998550415039062,359949171684469333
../DataSets\DelayGraph_1798.graphml,1001,1274,2275,0.0025000572204589844,359949171684469333
../DataSets\DelayGraph_1799.graphml,136,157,293,0.0,152
../DataSets\DelayGraph_1800.graphml,1030,1267,2297,0.0025000572204589844,119983057228159235
../DataSets\DelayGraph_1801.graphml,109,108,217,0.0,8
../DataSets\DelayGraph_1802.graphml,539,573,1112,0.0,197
../DataSets\DelayGraph_1803.graphml,719,801,1520,0.0,360
../DataSets\DelayGraph_1804.graphml,719,801,1520,0.0025000572204589844,360
../DataSets\DelayGraph_1805.graphml,35,33,68,0.0,5
../DataSets\DelayGraph_1806.graphml,531,561,1092,0.0025000572204589844,59
../DataSets\DelayGraph_1807.graphml,42,45,87,0.0,10
../DataSets\DelayGraph_1808.graphml,42,45,87,0.0,10
../DataSets\DelayGraph_1809.graphml,15,15,30,0.0,4
../DataSets\DelayGraph_1810.graphml,89,96,185,0.0,14
../DataSets\DelayGraph_1811.graphml,249,284,533,0.0025000572204589844,132
../DataSets\DelayGraph_1812.graphml,386,420,806,0.0,78
../DataSets\DelayGraph_1813.graphml,386,420,806,0.0,78
../DataSets\DelayGraph_1814.graphml,89,96,185,0.0009999275207519531,14
../DataSets\DelayGraph_1815.graphml,131,146,277,0.0025000572204589844,30
../DataSets\DelayGraph_1816.graphml,212,228,440,0.0,37
../DataSets\DelayGraph_1817.graphml,212,228,440,0.0,37
../DataSets\DelayGraph_1818.graphml,1873,2422,4295,0.004999876022338867,693
../DataSets\DelayGraph_1819.graphml,220,263,483,0.0010001659393310547,1172
../DataSets\DelayGraph_1820.graphml,1186,1571,2757,0.0029997825622558594,269185820927465307946
../DataSets\DelayGraph_1821.graphml,428,519,947,0.0025000572204589844,306959
../DataSets\DelayGraph_1822.graphml,1234,1549,2783,0.0025000572204589844,92916933112018481418
../DataSets\DelayGraph_1823.graphml,844,1031,1875,0.0,33894583359
../DataSets\DelayGraph_1824.graphml,116,135,251,0.0,74
../DataSets\DelayGraph_1825.graphml,1186,1571,2757,0.0025000572204589844,269185820927465307946
../DataSets\DelayGraph_1826.graphml,63,71,134,0.0,15
../DataSets\DelayGraph_1827.graphml,458,472,930,0.0,99
../DataSets\DelayGraph_1828.graphml,68,68,136,0.0,10
../DataSets\DelayGraph_1829.graphml,378,407,785,0.0,96
../DataSets\DelayGraph_1830.graphml,134,142,276,0.0,34
../DataSets\DelayGraph_1831.graphml,134,142,276,0.0,34
../DataSets\DelayGraph_1832.graphml,9,8,17,0.0,2
../DataSets\DelayGraph_1833.graphml,353,481,834,0.0,245
../DataSets\DelayGraph_1834.graphml,147,166,313,0.0,39
../DataSets\DelayGraph_1835.graphml,228,245,473,0.0025000572204589844,75
../DataSets\DelayGraph_1836.graphml,191,205,396,0.0025000572204589844,89
../DataSets\DelayGraph_1837.graphml,86,96,182,0.0,28
../DataSets\DelayGraph_1838.graphml,86,96,182,0.0,28
../DataSets\DelayGraph_1839.graphml,46,44,90,0.0,6
../DataSets\DelayGraph_1840.graphml,383,426,809,0.0,285
../DataSets\DelayGraph_1841.graphml,1237,1483,2720,0.0025000572204589844,83672062841
../DataSets\DelayGraph_1842.graphml,1237,1483,2720,0.0025000572204589844,83672062841
../DataSets\DelayGraph_1843.graphml,59,61,120,0.0,11
../DataSets\DelayGraph_1844.graphml,12847,15520,28367,0.047499895095825195,2158796786926
../DataSets\DelayGraph_1845.graphml,27,26,53,0.0,8
../DataSets\DelayGraph_1846.graphml,42,53,95,0.0,29
../DataSets\DelayGraph_1847.graphml,42,53,95,0.0,29
../DataSets\DelayGraph_1848.graphml,69,70,139,0.0,14
../DataSets\DelayGraph_1849.graphml,69,70,139,0.0,14
../DataSets\DelayGraph_1850.graphml,69,70,139,0.0,14
../DataSets\DelayGraph_1851.graphml,581,721,1302,0.0,325
../DataSets\DelayGraph_1852.graphml,581,721,1302,0.0025000572204589844,325
../DataSets\DelayGraph_1853.graphml,79,87,166,0.0,238
../DataSets\DelayGraph_1854.graphml,443,562,1005,0.0,137592941806577984982
../DataSets\DelayGraph_1855.graphml,371,459,830,0.0,140396484098418423
../DataSets\DelayGraph_1856.graphml,121,141,262,0.0,3071
../DataSets\DelayGraph_1857.graphml,436,550,986,0.0025000572204589844,137592941806577972023
../DataSets\DelayGraph_1858.graphml,169,206,375,0.0,330716
../DataSets\DelayGraph_1859.graphml,413,514,927,0.0,1311829648294604062
../DataSets\DelayGraph_1860.graphml,390,487,877,0.0,140396484098421117
../DataSets\DelayGraph_1861.graphml,128,153,281,0.0,17396
../DataSets\DelayGraph_1862.graphml,176,218,394,0.0,325015
../DataSets\DelayGraph_1863.graphml,421,526,947,0.0,627396788314824632
../DataSets\DelayGraph_1864.graphml,397,499,896,0.0,149171264354603605
../DataSets\DelayGraph_1865.graphml,417,522,939,0.0,137592941806577967958
../DataSets\DelayGraph_1866.graphml,102,113,215,0.0,346
../DataSets\DelayGraph_1867.graphml,394,496,890,0.0,137592941806577967890
../DataSets\DelayGraph_1868.graphml,127,152,279,0.0,307923
../DataSets\DelayGraph_1869.graphml,372,460,832,0.0,912577146661553740
../DataSets\DelayGraph_1870.graphml,348,433,781,0.0,193045165635325130
../DataSets\DelayGraph_1871.graphml,150,178,328,0.0,205391
../DataSets\DelayGraph_1872.graphml,393,486,879,0.0025000572204589844,912577146639718804
../DataSets\DelayGraph_1873.graphml,348,433,781,0.0,96522582817662568
../DataSets\DelayGraph_1874.graphml,35,34,69,0.0,5
../DataSets\DelayGraph_1875.graphml,97,103,200,0.0,31
../DataSets\DelayGraph_1876.graphml,443,556,999,0.0,103232213
../DataSets\DelayGraph_1877.graphml,301,354,655,0.0,6974
../DataSets\DelayGraph_1878.graphml,138,159,297,0.0,164
../DataSets\DelayGraph_1879.graphml,436,521,957,0.0,425404
../DataSets\DelayGraph_1880.graphml,443,556,999,0.0,103232213
../DataSets\DelayGraph_1881.graphml,193,224,417,0.0,583
../DataSets\DelayGraph_1882.graphml,113,133,246,0.0025000572204589844,81
../DataSets\DelayGraph_1883.graphml,218,261,479,0.0,1298
../DataSets\DelayGraph_1884.graphml,334,411,745,0.0,330291
../DataSets\DelayGraph_1885.graphml,61,69,130,0.0,13
../DataSets\DelayGraph_1886.graphml,356,465,821,0.0025000572204589844,3825263
../DataSets\DelayGraph_1887.graphml,356,465,821,0.0,3825263
../DataSets\DelayGraph_1888.graphml,97,103,200,0.0,31
../DataSets\DelayGraph_1889.graphml,2196,2409,4605,0.006000041961669922,804
../DataSets\DelayGraph_1890.graphml,21689,29661,51350,0.06799983978271484,1156093
../DataSets\DelayGraph_1891.graphml,21861,33188,55049,0.08699989318847656,456998944118
../DataSets\DelayGraph_1892.graphml,21689,29661,51350,0.09599995613098145,1156100
../DataSets\DelayGraph_1893.graphml,4025,5712,9737,0.01399993896484375,4870
../DataSets\DelayGraph_1894.graphml,94183,127502,221685,0.8159999847412109,35174314
../DataSets\DelayGraph_1895.graphml,20975,32674,53649,0.10050010681152344,1304560835187
../DataSets\DelayGraph_1896.graphml,94183,127502,221685,0.8050000667572021,35174314
../DataSets\DelayGraph_1897.graphml,63,63,126,0.004999876022338867,9
../DataSets\DelayGraph_1898.graphml,1063,1322,2385,0.0025000572204589844,366
../DataSets\DelayGraph_1899.graphml,119481,189058,308539,0.4765000343322754,139158
../DataSets\DelayGraph_1900.graphml,119481,189058,308539,0.48800015449523926,139158
../DataSets\DelayGraph_1901.graphml,1599,2075,3674,0.009000062942504883,161
../DataSets\DelayGraph_1902.graphml,6798,8786,15584,0.019999980926513672,772
../DataSets\DelayGraph_1903.graphml,2419,3108,5527,0.006000041961669922,1357
../DataSets\DelayGraph_1904.graphml,1873,2422,4295,0.005000114440917969,693
../DataSets\DelayGraph_1905.graphml,1873,2422,4295,0.004000186920166016,693
../DataSets\DelayGraph_1906.graphml,139,149,288,0.0,16
../DataSets\DelayGraph_1907.graphml,126,147,273,0.0,276
../DataSets\DelayGraph_1908.graphml,126,147,273,0.0,275
../DataSets\DelayGraph_1909.graphml,1060,1373,2433,0.0025000572204589844,145779414532210395240
../DataSets\DelayGraph_1910.graphml,139,149,288,0.0010001659393310547,16
../DataSets\DelayGraph_1911.graphml,60,50,110,0.0,10
../DataSets\DelayGraph_1912.graphml,60,50,110,0.0,10
../DataSets\DelayGraph_1913.graphml,84,94,178,0.0,11
../DataSets\DelayGraph_1914.graphml,113,129,242,0.0009999275207519531,33
../DataSets\DelayGraph_1915.graphml,113,129,242,0.0,33
../DataSets\DelayGraph_1916.graphml,18,18,36,0.0,2
../DataSets\DelayGraph_1917.graphml,878,1101,1979,0.0025000572204589844,453313204489479
../DataSets\DelayGraph_1918.graphml,878,1101,1979,0.0019998550415039062,453313204489479
../DataSets\DelayGraph_1919.graphml,176,206,382,0.0009999275207519531,167
../DataSets\DelayGraph_1920.graphml,863,1067,1930,0.002499818801879883,3648968262708
../DataSets\DelayGraph_1921.graphml,18,18,36,0.0,2
../DataSets\DelayGraph_1922.graphml,6,5,11,0.0,1
../DataSets\DelayGraph_1923.graphml,335,331,666,0.0,60
../DataSets\DelayGraph_1924.graphml,335,331,666,0.0,60
../DataSets\DelayGraph_1925.graphml,1647,1773,3420,0.004999876022338867,2275
../DataSets\DelayGraph_1926.graphml,8415,10351,18766,0.029999971389770508,1505088513329988135
../DataSets\DelayGraph_1927.graphml,8415,10351,18766,0.03249979019165039,1505088513329988135
../DataSets\DelayGraph_1928.graphml,51,47,98,0.0,6
../DataSets\DelayGraph_1929.graphml,51,47,98,0.0,6
../DataSets\DelayGraph_1930.graphml,6371,8351,14722,0.0279998779296875,91496
../DataSets\DelayGraph_1931.graphml,4949,6059,11008,0.01399993896484375,116135
../DataSets\DelayGraph_1932.graphml,18528,25465,43993,0.05200004577636719,1080000
../DataSets\DelayGraph_1933.graphml,4949,6059,11008,0.01399993896484375,116134
../DataSets\DelayGraph_1934.graphml,550,580,1130,0.0009999275207519531,59
../DataSets\DelayGraph_1935.graphml,70,75,145,0.0009999275207519531,11
../DataSets\DelayGraph_1936.graphml,123,130,253,0.0009999275207519531,18
../DataSets\DelayGraph_1937.graphml,123,130,253,0.0,18
../DataSets\DelayGraph_1938.graphml,89,96,185,0.0009999275207519531,14
../DataSets\DelayGraph_1939.graphml,485,560,1045,0.0009999275207519531,2064
../DataSets\DelayGraph_1940.graphml,731,801,1532,0.0009999275207519531,172
../DataSets\DelayGraph_1941.graphml,731,801,1532,0.0010001659393310547,172
../DataSets\DelayGraph_1942.graphml,1594,2067,3661,0.004000186920166016,153
../DataSets\DelayGraph_1943.graphml,6915,8776,15691,0.021000146865844727,516
../DataSets\DelayGraph_1944.graphml,6915,8776,15691,0.02950000762939453,516
../DataSets\DelayGraph_1945.graphml,135,131,266,0.0009999275207519531,17
../DataSets\DelayGraph_1946.graphml,493,542,1035,0.0009999275207519531,42
../DataSets\DelayGraph_1947.graphml,999,1399,2398,0.003000020980834961,1438
../DataSets\DelayGraph_1948.graphml,999,1399,2398,0.002000093460083008,1438
../DataSets\DelayGraph_1949.graphml,3469,4210,7679,0.00800013542175293,8
../DataSets\DelayGraph_1950.graphml,237,307,544,0.0,519
../DataSets\DelayGraph_1951.graphml,320,334,654,0.002499818801879883,28
../DataSets\DelayGraph_1952.graphml,320,334,654,0.0,28
../DataSets\DelayGraph_1953.graphml,320,334,654,0.0009999275207519531,28
../DataSets\DelayGraph_1954.graphml,127,131,258,0.0,13
../DataSets\DelayGraph_1955.graphml,127,131,258,0.0,16
../DataSets\DelayGraph_1956.graphml,115,126,241,0.0,103
../DataSets\DelayGraph_1957.graphml,2556,4281,6837,0.004999876022338867,62809601736730
../DataSets\DelayGraph_1958.graphml,2801,3301,6102,0.0074999332427978516,6734508720176
../DataSets\DelayGraph_1959.graphml,2801,3301,6102,0.004999876022338867,6734508720176
../DataSets\DelayGraph_1960.graphml,195,222,417,0.0009999275207519531,40
../DataSets\DelayGraph_1961.graphml,195,222,417,0.0,40
../DataSets\DelayGraph_1962.graphml,20,19,39,0.0,7
../DataSets\DelayGraph_1963.graphml,19264,23484,42748,0.05500006675720215,1571361120146360325
../DataSets\DelayGraph_1964.graphml,30,29,59,0.0010001659393310547,7
../DataSets\DelayGraph_1965.graphml,56,60,116,0.0,22
../DataSets\DelayGraph_1966.graphml,47,50,97,0.0,17
../DataSets\DelayGraph_1967.graphml,22,24,46,0.0,8
../DataSets\DelayGraph_1968.graphml,22,24,46,0.0,8
../DataSets\DelayGraph_1969.graphml,74,94,168,0.0,62
../DataSets\DelayGraph_1970.graphml,74,94,168,0.0,62
../DataSets\DelayGraph_1971.graphml,412,501,913,0.0010001659393310547,2485
../DataSets\DelayGraph_1972.graphml,249,277,526,0.0009999275207519531,82
../DataSets\DelayGraph_1973.graphml,5046,7310,12356,0.013000011444091797,3690296397
../DataSets\DelayGraph_1974.graphml,5046,7310,12356,0.015000104904174805,3690296397
../DataSets\DelayGraph_1975.graphml,47,48,95,0.0009999275207519531,11
../DataSets\DelayGraph_1976.graphml,47,48,95,0.0,11
../DataSets\DelayGraph_1977.graphml,47,48,95,0.0,11
../DataSets\DelayGraph_1978.graphml,43,44,87,0.0,6
../DataSets\DelayGraph_1979.graphml,358,402,760,0.0010001659393310547,63
../DataSets\DelayGraph_1980.graphml,358,402,760,0.0009999275207519531,63
../DataSets\DelayGraph_1981.graphml,159,169,328,0.0,26
../DataSets\DelayGraph_1982.graphml,71,76,147,0.0009999275207519531,34
../DataSets\DelayGraph_1983.graphml,133,143,276,0.0,16
../DataSets\DelayGraph_1984.graphml,1060,1373,2433,0.003000020980834961,145779414532210395240
../DataSets\DelayGraph_1985.graphml,126,147,273,0.0,278
../DataSets\DelayGraph_1986.graphml,126,147,273,0.0,275
../DataSets\DelayGraph_1987.graphml,133,143,276,0.0,16
../DataSets\DelayGraph_1988.graphml,634,711,1345,0.0009999275207519531,1253
../DataSets\DelayGraph_1989.graphml,634,711,1345,0.002000093460083008,1253
../DataSets\DelayGraph_1990.graphml,36,36,72,0.0,2
../DataSets\DelayGraph_1991.graphml,36,36,72,0.0,2
../DataSets\DelayGraph_1992.graphml,112,121,233,0.0010001659393310547,31
../DataSets\DelayGraph_1993.graphml,5434,6321,11755,0.017999887466430664,2116501557122
../DataSets\DelayGraph_1994.graphml,5434,6321,11755,0.017999887466430664,2116501557122
../DataSets\DelayGraph_1995.graphml,76,84,160,0.0,52
../DataSets\DelayGraph_1996.graphml,76,84,160,0.0,52
../DataSets\DelayGraph_1997.graphml,189,200,389,0.0,14
../DataSets\DelayGraph_1998.graphml,131,132,263,0.0,32
../DataSets\DelayGraph_1999.graphml,131,132,263,0.0,46
../DataSets\DelayGraph_2000.graphml,181,212,393,0.0,169
../DataSets\DelayGraph_2001.graphml,458,565,1023,0.0010001659393310547,9290374
../DataSets\DelayGraph_2002.graphml,473,587,1060,0.0,46431763
../DataSets\DelayGraph_2003.graphml,473,587,1060,0.0,46431763
../DataSets\DelayGraph_2004.graphml,450,553,1003,0.0025000572204589844,1284398
../DataSets\DelayGraph_2005.graphml,435,543,978,0.0,11437436
../DataSets\DelayGraph_2006.graphml,435,543,978,0.0,11437436
../DataSets\DelayGraph_2007.graphml,135,159,294,0.0,53
../DataSets\DelayGraph_2008.graphml,449,551,1000,0.0,1284398
../DataSets\DelayGraph_2009.graphml,434,541,975,0.002499818801879883,11437436
../DataSets\DelayGraph_2010.graphml,134,157,291,0.0,53
../DataSets\DelayGraph_2011.graphml,434,541,975,0.0009999275207519531,11437436
../DataSets\DelayGraph_2012.graphml,457,563,1020,0.0025000572204589844,9290374
../DataSets\DelayGraph_2013.graphml,472,585,1057,0.0025000572204589844,46431763
../DataSets\DelayGraph_2014.graphml,180,210,390,0.0,169
../DataSets\DelayGraph_2015.graphml,472,585,1057,0.0009999275207519531,46431763
../DataSets\DelayGraph_2016.graphml,131,132,263,0.0,35
../DataSets\DelayGraph_2017.graphml,41,36,77,0.0,8
../DataSets\DelayGraph_2018.graphml,41,36,77,0.0,9
../DataSets\DelayGraph_2019.graphml,41,36,77,0.0,9
../DataSets\DelayGraph_2020.graphml,16,12,28,0.0,4
../DataSets\DelayGraph_2021.graphml,16,12,28,0.0,4
../DataSets\DelayGraph_2022.graphml,350,398,748,0.0025000572204589844,120
../DataSets\DelayGraph_2023.graphml,570,758,1328,0.002000093460083008,1056
../DataSets\DelayGraph_2024.graphml,570,758,1328,0.0025000572204589844,1056
../DataSets\DelayGraph_2025.graphml,6,4,10,0.0,2
../DataSets\DelayGraph_2026.graphml,6,4,10,0.0,2
../DataSets\DelayGraph_2027.graphml,6,4,10,0.0,2
../DataSets\DelayGraph_2028.graphml,6,4,10,0.0,2
../DataSets\DelayGraph_2029.graphml,12,11,23,0.0,3
../DataSets\DelayGraph_2030.graphml,12,11,23,0.0,3
../DataSets\DelayGraph_2031.graphml,649,744,1393,0.0025000572204589844,266
../DataSets\DelayGraph_2032.graphml,649,744,1393,0.0009999275207519531,266
../DataSets\DelayGraph_2033.graphml,1961,2517,4478,0.005000114440917969,1607
../DataSets\DelayGraph_2034.graphml,133,140,273,0.0,27
../DataSets\DelayGraph_2035.graphml,46,50,96,0.0,11
../DataSets\DelayGraph_2036.graphml,46,50,96,0.0,11
../DataSets\DelayGraph_2037.graphml,428,519,947,0.0,314371
../DataSets\DelayGraph_2038.graphml,1234,1549,2783,0.004999876022338867,76519827268721102230
../DataSets\DelayGraph_2039.graphml,1186,1571,2757,0.003000020980834961,269185820927465307946
../DataSets\DelayGraph_2040.graphml,220,263,483,0.0025000572204589844,1081
../DataSets\DelayGraph_2041.graphml,1186,1571,2757,0.004999876022338867,269185820927465307946
../DataSets\DelayGraph_2042.graphml,63,71,134,0.0,13
../DataSets\DelayGraph_2043.graphml,116,135,251,0.0,81
../DataSets\DelayGraph_2044.graphml,844,1031,1875,0.0019998550415039062,20089155136
../DataSets\DelayGraph_2045.graphml,475,488,963,0.0025000572204589844,105
../DataSets\DelayGraph_2046.graphml,81,95,176,0.0,16
../DataSets\DelayGraph_2047.graphml,3182,4162,7344,0.0074999332427978516,126037
../DataSets\DelayGraph_2048.graphml,173,199,372,0.0,184
../DataSets\DelayGraph_2049.graphml,278,312,590,0.0,96
../DataSets\DelayGraph_2050.graphml,216,239,455,0.0,76
../DataSets\DelayGraph_2051.graphml,373,432,805,0.002499818801879883,446
../DataSets\DelayGraph_2052.graphml,95,103,198,0.0,27
../DataSets\DelayGraph_2053.graphml,568,684,1252,0.0,724
../DataSets\DelayGraph_2054.graphml,568,684,1252,0.0025000572204589844,724
../DataSets\DelayGraph_2055.graphml,67,72,139,0.0025000572204589844,34
../DataSets\DelayGraph_2056.graphml,34,33,67,0.0,6
../DataSets\DelayGraph_2057.graphml,34,33,67,0.0,6
../DataSets\DelayGraph_2058.graphml,34,33,67,0.0,6
../DataSets\DelayGraph_2059.graphml,78,83,161,0.0,19
../DataSets\DelayGraph_2060.graphml,25,24,49,0.0,7
../DataSets\DelayGraph_2061.graphml,37,37,74,0.0,5
../DataSets\DelayGraph_2062.graphml,106,109,215,0.0,10
../DataSets\DelayGraph_2063.graphml,473,587,1060,0.0,46431763
../DataSets\DelayGraph_2064.graphml,458,565,1023,0.0009999275207519531,9290374
../DataSets\DelayGraph_2065.graphml,181,212,393,0.0,169
../DataSets\DelayGraph_2066.graphml,473,587,1060,0.0,46431763
../DataSets\DelayGraph_2067.graphml,106,109,215,0.0,10
../DataSets\DelayGraph_2068.graphml,111,118,229,0.0,18
../DataSets\DelayGraph_2069.graphml,111,118,229,0.0,18
../DataSets\DelayGraph_2070.graphml,146,164,310,0.0,38
../DataSets\DelayGraph_2071.graphml,146,164,310,0.0,38
../DataSets\DelayGraph_2072.graphml,146,164,310,0.0,38
../DataSets\DelayGraph_2073.graphml,72,75,147,0.0,18
../DataSets\DelayGraph_2074.graphml,72,75,147,0.0,18
../DataSets\DelayGraph_2075.graphml,111,122,233,0.0,22
../DataSets\DelayGraph_2076.graphml,128,142,270,0.0,27
../DataSets\DelayGraph_2077.graphml,111,122,233,0.0,21
../DataSets\DelayGraph_2078.graphml,84,91,175,0.0,17
../DataSets\DelayGraph_2079.graphml,84,91,175,0.0009999275207519531,17
../DataSets\DelayGraph_2080.graphml,84,91,175,0.0,17
../DataSets\DelayGraph_2081.graphml,122,126,248,0.0,12
../DataSets\DelayGraph_2082.graphml,426,517,943,0.0010001659393310547,323224
../DataSets\DelayGraph_2083.graphml,61,69,130,0.0,15
../DataSets\DelayGraph_2084.graphml,644,849,1493,0.0025000572204589844,250698831527
../DataSets\DelayGraph_2085.graphml,638,795,1433,0.0010001659393310547,18889902247
../DataSets\DelayGraph_2086.graphml,644,849,1493,0.0010001659393310547,250698831527
../DataSets\DelayGraph_2087.graphml,122,126,248,0.0,9
../DataSets\DelayGraph_2088.graphml,1854,1997,3851,0.004999876022338867,3010
../DataSets\DelayGraph_2089.graphml,4881,5724,10605,0.01100015640258789,65887855398377690970000
../DataSets\DelayGraph_2090.graphml,867,1123,1990,0.002000093460083008,39994352409384863
../DataSets\DelayGraph_2091.graphml,117,137,254,0.0,151
../DataSets\DelayGraph_2092.graphml,867,1123,1990,0.0025000572204589844,39994352409384863
../DataSets\DelayGraph_2093.graphml,853,1033,1886,0.002000093460083008,3061099753
../DataSets\DelayGraph_2094.graphml,696,861,1557,0.002000093460083008,20911090678
../DataSets\DelayGraph_2095.graphml,790,1043,1833,0.0019998550415039062,64178900939427
../DataSets\DelayGraph_2096.graphml,790,1043,1833,0.002000093460083008,64178900939427
../DataSets\DelayGraph_2097.graphml,63,71,134,0.0009999275207519531,13
../DataSets\DelayGraph_2098.graphml,4881,5724,10605,0.010999917984008789,65887855398377690970000
../DataSets\DelayGraph_2099.graphml,74,83,157,0.0009999275207519531,14
../DataSets\DelayGraph_2100.graphml,174,244,418,0.0,958
../DataSets\DelayGraph_2101.graphml,174,244,418,0.0,958
../DataSets\DelayGraph_2102.graphml,75,74,149,0.0,13
../DataSets\DelayGraph_2103.graphml,75,74,149,0.0,13
../DataSets\DelayGraph_2104.graphml,6,5,11,0.0,1
../DataSets\DelayGraph_2105.graphml,6,5,11,0.0,1
../DataSets\DelayGraph_2106.graphml,101,99,200,0.0,4
../DataSets\DelayGraph_2107.graphml,101,99,200,0.0,4
../DataSets\DelayGraph_2108.graphml,39,36,75,0.0,8
../DataSets\DelayGraph_2109.graphml,39,36,75,0.0,8
../DataSets\DelayGraph_2110.graphml,112,121,233,0.0,31
../DataSets\DelayGraph_2111.graphml,666,769,1435,0.0019998550415039062,46082
../DataSets\DelayGraph_2112.graphml,666,769,1435,0.002000093460083008,46082
../DataSets\DelayGraph_2113.graphml,204,214,418,0.0,48
../DataSets\DelayGraph_2114.graphml,643,838,1481,0.002000093460083008,1030
../DataSets\DelayGraph_2115.graphml,643,838,1481,0.0,1030
../DataSets\DelayGraph_2116.graphml,244,269,513,0.0009999275207519531,84
../DataSets\DelayGraph_2117.graphml,534,601,1135,0.0009999275207519531,300
../DataSets\DelayGraph_2118.graphml,181,212,393,0.0009999275207519531,169
../DataSets\DelayGraph_2119.graphml,473,587,1060,0.0009999275207519531,46431763
../DataSets\DelayGraph_2120.graphml,473,587,1060,0.0010001659393310547,46431763
../DataSets\DelayGraph_2121.graphml,458,565,1023,0.0,9290374
../DataSets\DelayGraph_2122.graphml,450,553,1003,0.0009999275207519531,1284398
../DataSets\DelayGraph_2123.graphml,135,159,294,0.0,53
../DataSets\DelayGraph_2124.graphml,435,543,978,0.0009999275207519531,11437436
../DataSets\DelayGraph_2125.graphml,435,543,978,0.0009999275207519531,11437436
../DataSets\DelayGraph_2126.graphml,434,541,975,0.0010001659393310547,11437436
../DataSets\DelayGraph_2127.graphml,434,541,975,0.0010001659393310547,11437436
../DataSets\DelayGraph_2128.graphml,134,157,291,0.0,53
../DataSets\DelayGraph_2129.graphml,449,551,1000,0.0010001659393310547,1284398
../DataSets\DelayGraph_2130.graphml,457,563,1020,0.0010001659393310547,9290374
../DataSets\DelayGraph_2131.graphml,180,210,390,0.0,169
../DataSets\DelayGraph_2132.graphml,472,585,1057,0.002499818801879883,46431763
../DataSets\DelayGraph_2133.graphml,472,585,1057,0.0,46431763
../DataSets\DelayGraph_2134.graphml,534,601,1135,0.0009999275207519531,300
../DataSets\DelayGraph_2135.graphml,252,259,511,0.0,62
../DataSets\DelayGraph_2136.graphml,224,267,491,0.0,105
../DataSets\DelayGraph_2137.graphml,224,267,491,0.0,105
../DataSets\DelayGraph_2138.graphml,334,341,675,0.0,81
../DataSets\DelayGraph_2139.graphml,334,341,675,0.0,90
../DataSets\DelayGraph_2140.graphml,585,623,1208,0.0009999275207519531,518
../DataSets\DelayGraph_2141.graphml,1645,2042,3687,0.002499818801879883,141612
../DataSets\DelayGraph_2142.graphml,1645,2042,3687,0.004999876022338867,141612
../DataSets\DelayGraph_2143.graphml,166,169,335,0.0,29
../DataSets\DelayGraph_2144.graphml,203,219,422,0.0,47
../DataSets\DelayGraph_2145.graphml,203,219,422,0.0009999275207519531,47
../DataSets\DelayGraph_2146.graphml,55,53,108,0.0,13
../DataSets\DelayGraph_2147.graphml,55,53,108,0.0,13
../DataSets\DelayGraph_2148.graphml,55,53,108,0.0,13
../DataSets\DelayGraph_2149.graphml,105,109,214,0.0009999275207519531,29
../DataSets\DelayGraph_2150.graphml,105,109,214,0.0,39
../DataSets\DelayGraph_2151.graphml,105,109,214,0.0,24
../DataSets\DelayGraph_2152.graphml,248,267,515,0.0010001659393310547,57
../DataSets\DelayGraph_2153.graphml,293,357,650,0.0,155
../DataSets\DelayGraph_2154.graphml,293,357,650,0.0009999275207519531,155
../DataSets\DelayGraph_2155.graphml,14,13,27,0.0,3
../DataSets\DelayGraph_2156.graphml,24,23,47,0.0,5
../DataSets\DelayGraph_2157.graphml,24,23,47,0.0,5
../DataSets\DelayGraph_2158.graphml,212,228,440,0.0009999275207519531,37
../DataSets\DelayGraph_2159.graphml,23,22,45,0.0,4
../DataSets\DelayGraph_2160.graphml,42,44,86,0.0,8
../DataSets\DelayGraph_2161.graphml,42,44,86,0.0,8
../DataSets\DelayGraph_2162.graphml,12,12,24,0.0,4
../DataSets\DelayGraph_2163.graphml,68,68,136,0.0,10
../DataSets\DelayGraph_2164.graphml,161,164,325,0.0,22
../DataSets\DelayGraph_2165.graphml,39,38,77,0.0,8
../DataSets\DelayGraph_2166.graphml,39,38,77,0.0,8
../DataSets\DelayGraph_2167.graphml,71,77,148,0.0,12
../DataSets\DelayGraph_2168.graphml,71,77,148,0.0,13
../DataSets\DelayGraph_2169.graphml,2783,9337,12120,0.009999990463256836,11
../DataSets\DelayGraph_2170.graphml,1480,8116,9596,0.005000114440917969,3
../DataSets\DelayGraph_2171.graphml,1480,8116,9596,0.004999876022338867,3
../DataSets\DelayGraph_2172.graphml,122,131,253,0.0,20
../DataSets\DelayGraph_2173.graphml,650,786,1436,0.002000093460083008,4724377514
../DataSets\DelayGraph_2174.graphml,650,786,1436,0.0019998550415039062,4724377514
../DataSets\DelayGraph_2175.graphml,19,19,38,0.0,6
../DataSets\DelayGraph_2176.graphml,13,13,26,0.0,4
../DataSets\DelayGraph_2177.graphml,30,28,58,0.0,7
../DataSets\DelayGraph_2178.graphml,13,13,26,0.0009999275207519531,4
../DataSets\DelayGraph_2179.graphml,18,12,30,0.0,6
../DataSets\DelayGraph_2180.graphml,18,12,30,0.0,6
../DataSets\DelayGraph_2181.graphml,17,16,33,0.0,1
../DataSets\DelayGraph_2182.graphml,473,587,1060,0.0010001659393310547,46431763
../DataSets\DelayGraph_2183.graphml,458,565,1023,0.0009999275207519531,9290374
../DataSets\DelayGraph_2184.graphml,181,212,393,0.0,169
../DataSets\DelayGraph_2185.graphml,473,587,1060,0.0010001659393310547,46431763
../DataSets\DelayGraph_2186.graphml,17,16,33,0.0,1
../DataSets\DelayGraph_2187.graphml,18,17,35,0.0,5
../DataSets\DelayGraph_2188.graphml,18,17,35,0.0,5
../DataSets\DelayGraph_2189.graphml,142,143,285,0.0010001659393310547,17
../DataSets\DelayGraph_2190.graphml,114,132,246,0.0,26
../DataSets\DelayGraph_2191.graphml,767,964,1731,0.0019998550415039062,1585027642257
../DataSets\DelayGraph_2192.graphml,790,976,1766,0.002000093460083008,46494522868
../DataSets\DelayGraph_2193.graphml,767,964,1731,0.0009999275207519531,1585027642257
../DataSets\DelayGraph_2194.graphml,142,143,285,0.0,17
../DataSets\DelayGraph_2195.graphml,51,46,97,0.0,7
../DataSets\DelayGraph_2196.graphml,51,46,97,0.0,7
../DataSets\DelayGraph_2197.graphml,28,29,57,0.0,8
../DataSets\DelayGraph_2198.graphml,28,29,57,0.0,8
../DataSets\DelayGraph_2199.graphml,133,134,267,0.0,15
../DataSets\DelayGraph_2200.graphml,1968,2189,4157,0.005000114440917969,284
../DataSets\DelayGraph_2201.graphml,1968,2189,4157,0.004999876022338867,284
../DataSets\DelayGraph_2202.graphml,184,225,409,0.0,9
../DataSets\DelayGraph_2203.graphml,132,141,273,0.0,7
../DataSets\DelayGraph_2204.graphml,132,141,273,0.0,7
../DataSets\DelayGraph_2205.graphml,78,83,161,0.0,19
../DataSets\DelayGraph_2206.graphml,708,863,1571,0.0025000572204589844,194847719128
../DataSets\DelayGraph_2207.graphml,708,863,1571,0.002000093460083008,194847719128
../DataSets\DelayGraph_2208.graphml,41,40,81,0.0,7
../DataSets\DelayGraph_2209.graphml,10,9,19,0.0,2
../DataSets\DelayGraph_2210.graphml,10,9,19,0.0,2
../DataSets\DelayGraph_2211.graphml,58,62,120,0.0,12
../DataSets\DelayGraph_2212.graphml,58,62,120,0.0,12
../DataSets\DelayGraph_2213.graphml,66,63,129,0.0,12
../DataSets\DelayGraph_2214.graphml,66,63,129,0.0,12
../DataSets\DelayGraph_2215.graphml,16,15,31,0.0,3
../DataSets\DelayGraph_2216.graphml,6,5,11,0.0,1
../DataSets\DelayGraph_2217.graphml,507,554,1061,0.002000093460083008,131
../DataSets\DelayGraph_2218.graphml,189,219,408,0.0,94
../DataSets\DelayGraph_2219.graphml,192,210,402,0.0009999275207519531,66
../DataSets\DelayGraph_2220.graphml,192,210,402,0.0010001659393310547,66
../DataSets\DelayGraph_2221.graphml,426,460,886,0.0019998550415039062,122
../DataSets\DelayGraph_2222.graphml,426,460,886,0.0009999275207519531,122
../DataSets\DelayGraph_2223.graphml,958,1135,2093,0.003000020980834961,433
../DataSets\DelayGraph_2224.graphml,958,1135,2093,0.0019998550415039062,433
../DataSets\DelayGraph_2225.graphml,19,17,36,0.0,3
../DataSets\DelayGraph_2226.graphml,31,29,60,0.0,5
../DataSets\DelayGraph_2227.graphml,143,148,291,0.0,17
../DataSets\DelayGraph_2228.graphml,12,11,23,0.0,3
../DataSets\DelayGraph_2229.graphml,12,11,23,0.0,3
../DataSets\DelayGraph_2230.graphml,65,70,135,0.0,16
../DataSets\DelayGraph_2231.graphml,88,94,182,0.0,24
../DataSets\DelayGraph_2232.graphml,1950,2509,4459,0.004999876022338867,45360
../DataSets\DelayGraph_2233.graphml,3635,4590,8225,0.0074999332427978516,2685
../DataSets\DelayGraph_2234.graphml,133,140,273,0.0,27
../DataSets\DelayGraph_2235.graphml,46,50,96,0.0,11
../DataSets\DelayGraph_2236.graphml,46,50,96,0.0,11
../DataSets\DelayGraph_2237.graphml,209,215,424,0.0,37
../DataSets\DelayGraph_2238.graphml,265,316,581,0.0010001659393310547,127
../DataSets\DelayGraph_2239.graphml,92,94,186,0.0,14
../DataSets\DelayGraph_2240.graphml,55,59,114,0.0,4
../DataSets\DelayGraph_2241.graphml,25,27,52,0.0,4
../DataSets\DelayGraph_2242.graphml,25,27,52,0.0,4
../DataSets\DelayGraph_2243.graphml,38,41,79,0.0,16
../DataSets\DelayGraph_2244.graphml,78,83,161,0.0,8
../DataSets\DelayGraph_2245.graphml,78,83,161,0.0,8
../DataSets\DelayGraph_2246.graphml,7703,9320,17023,0.026000022888183594,329030446
../DataSets\DelayGraph_2247.graphml,25,27,52,0.0010001659393310547,9
../DataSets\DelayGraph_2248.graphml,85,94,179,0.0,17
../DataSets\DelayGraph_2249.graphml,85,94,179,0.0,17
../DataSets\DelayGraph_2250.graphml,55,55,110,0.0,12
../DataSets\DelayGraph_2251.graphml,55,55,110,0.0,12
../DataSets\DelayGraph_2252.graphml,260,276,536,0.0,18
../DataSets\DelayGraph_2253.graphml,260,276,536,0.0,18
../DataSets\DelayGraph_2254.graphml,66,74,140,0.0,25
../DataSets\DelayGraph_2255.graphml,66,74,140,0.0,25
../DataSets\DelayGraph_2256.graphml,66,74,140,0.0,25
../DataSets\DelayGraph_2257.graphml,90,96,186,0.0,24
../DataSets\DelayGraph_2258.graphml,90,96,186,0.0,24
../DataSets\DelayGraph_2259.graphml,706,897,1603,0.0009999275207519531,379
../DataSets\DelayGraph_2260.graphml,4331,25251,29582,0.020000219345092773,15
../DataSets\DelayGraph_2261.graphml,706,897,1603,0.002499818801879883,379
../DataSets\DelayGraph_2262.graphml,122,126,248,0.0,10
../DataSets\DelayGraph_2263.graphml,61,69,130,0.0,13
../DataSets\DelayGraph_2264.graphml,426,517,943,0.0009999275207519531,301685
../DataSets\DelayGraph_2265.graphml,644,849,1493,0.0025000572204589844,250698831527
../DataSets\DelayGraph_2266.graphml,644,849,1493,0.0019998550415039062,250698831527
../DataSets\DelayGraph_2267.graphml,638,795,1433,0.0009999275207519531,25093743874
../DataSets\DelayGraph_2268.graphml,122,126,248,0.0,9
../DataSets\DelayGraph_2269.graphml,41,42,83,0.0010001659393310547,10
../DataSets\DelayGraph_2270.graphml,10,9,19,0.0,2
../DataSets\DelayGraph_2271.graphml,10,9,19,0.0,2
../DataSets\DelayGraph_2272.graphml,190,211,401,0.0,146
../DataSets\DelayGraph_2273.graphml,183,223,406,0.0,77
../DataSets\DelayGraph_2274.graphml,183,223,406,0.0,70
../DataSets\DelayGraph_2275.graphml,183,223,406,0.0,77
../DataSets\DelayGraph_2276.graphml,9,9,18,0.0,2
../DataSets\DelayGraph_2277.graphml,78,76,154,0.0009999275207519531,10
../DataSets\DelayGraph_2278.graphml,74,84,158,0.0009999275207519531,16
../DataSets\DelayGraph_2279.graphml,74,84,158,0.0,16
../DataSets\DelayGraph_2280.graphml,74,84,158,0.0,16
../DataSets\DelayGraph_2281.graphml,144,155,299,0.0,14
../DataSets\DelayGraph_2282.graphml,25,25,50,0.0,5
../DataSets\DelayGraph_2283.graphml,46,49,95,0.0,10
../DataSets\DelayGraph_2284.graphml,46,49,95,0.0,10
../DataSets\DelayGraph_2285.graphml,113,125,238,0.0,38
../DataSets\DelayGraph_2286.graphml,113,125,238,0.0,38
../DataSets\DelayGraph_2287.graphml,113,125,238,0.0,38
../DataSets\DelayGraph_2288.graphml,666,726,1392,0.002000093460083008,256
../DataSets\DelayGraph_2289.graphml,474,598,1072,0.0009999275207519531,455
../DataSets\DelayGraph_2290.graphml,474,598,1072,0.0009999275207519531,455
../DataSets\DelayGraph_2291.graphml,206,221,427,0.0,49
../DataSets\DelayGraph_2292.graphml,254,307,561,0.0,125
../DataSets\DelayGraph_2293.graphml,254,307,561,0.0,125
../DataSets\DelayGraph_2294.graphml,75,74,149,0.0,24
../DataSets\DelayGraph_2295.graphml,75,74,149,0.0,24
../DataSets\DelayGraph_2296.graphml,75,74,149,0.0,16
../DataSets\DelayGraph_2297.graphml,202,208,410,0.0,24
../DataSets\DelayGraph_2298.graphml,583,607,1190,0.0009999275207519531,60
../DataSets\DelayGraph_2299.graphml,1057,1368,2425,0.0,48593138177403464450
../DataSets\DelayGraph_2300.graphml,1057,1368,2425,0.002000093460083008,48593138177403464450
../DataSets\DelayGraph_2301.graphml,1079,1338,2417,0.003000020980834961,200658065820575853
../DataSets\DelayGraph_2302.graphml,149,176,325,0.0,291
../DataSets\DelayGraph_2303.graphml,618,795,1413,0.0,1128846449413
../DataSets\DelayGraph_2304.graphml,624,765,1389,0.0010001659393310547,4770346995
../DataSets\DelayGraph_2305.graphml,618,795,1413,0.0009999275207519531,1128846449413
../DataSets\DelayGraph_2306.graphml,126,147,273,0.0,278
../DataSets\DelayGraph_2307.graphml,718,947,1665,0.002499818801879883,4011181308413
../DataSets\DelayGraph_2308.graphml,63,71,134,0.0025000572204589844,13
../DataSets\DelayGraph_2309.graphml,668,829,1497,0.0025000572204589844,19314952825
../DataSets\DelayGraph_2310.graphml,718,947,1665,0.0,4011181308413
../DataSets\DelayGraph_2311.graphml,583,607,1190,0.0009999275207519531,60
../DataSets\DelayGraph_2312.graphml,28,25,53,0.0,7
../DataSets\DelayGraph_2313.graphml,28,25,53,0.0009999275207519531,6
../DataSets\DelayGraph_2314.graphml,28,25,53,0.0,7
../DataSets\DelayGraph_2315.graphml,35,36,71,0.0,4
../DataSets\DelayGraph_2316.graphml,14,13,27,0.0,3
../DataSets\DelayGraph_2317.graphml,14,13,27,0.0,3
../DataSets\DelayGraph_2318.graphml,163,174,337,0.0009999275207519531,58
../DataSets\DelayGraph_2319.graphml,163,174,337,0.0010001659393310547,58
../DataSets\DelayGraph_2320.graphml,20,21,41,0.0,6
../DataSets\DelayGraph_2321.graphml,20,21,41,0.0,6
../DataSets\DelayGraph_2322.graphml,20,21,41,0.0,6
../DataSets\DelayGraph_2323.graphml,20,21,41,0.0,6
../DataSets\DelayGraph_2324.graphml,4,3,7,0.0,1
../DataSets\DelayGraph_2325.graphml,79,86,165,0.0,12
../DataSets\DelayGraph_2326.graphml,1303,1743,3046,0.002000093460083008,357
../DataSets\DelayGraph_2327.graphml,6870,8722,15592,0.020999908447265625,516
../DataSets\DelayGraph_2328.graphml,6870,8722,15592,0.025999784469604492,516
../DataSets\DelayGraph_2329.graphml,42,44,86,0.0,8
../DataSets\DelayGraph_2330.graphml,42,44,86,0.0,8
../DataSets\DelayGraph_2331.graphml,106,105,211,0.0,16
../DataSets\DelayGraph_2332.graphml,90,89,179,0.0009999275207519531,12
