..\DataSets\DelayGraph_0.graphml,91,106,197,0.0,126,1
..\DataSets\DelayGraph_1.graphml,91,106,197,0.0,126,1
..\DataSets\DelayGraph_2.graphml,120,134,254,0.0,130,3
..\DataSets\DelayGraph_4.graphml,118,138,256,0.0,150,5
..\DataSets\DelayGraph_9.graphml,61,69,130,0.0,11,6
..\DataSets\DelayGraph_15.graphml,120,134,254,0.0,130,3
..\DataSets\DelayGraph_16.graphml,83,86,169,0.0,28,0
..\DataSets\DelayGraph_18.graphml,145,167,312,0.0,274,5
..\DataSets\DelayGraph_19.graphml,145,167,312,0.0,274,5
..\DataSets\DelayGraph_20.graphml,212,250,462,0.0,196,22
..\DataSets\DelayGraph_23.graphml,212,250,462,0.0,196,22
..\DataSets\DelayGraph_25.graphml,128,150,278,0.0,51,11
..\DataSets\DelayGraph_27.graphml,83,86,169,0.0,28,0
..\DataSets\DelayGraph_29.graphml,1587,2063,3650,0.0,161,106
..\DataSets\DelayGraph_32.graphml,1401,1862,3263,0.0,506,74
..\DataSets\DelayGraph_35.graphml,8,6,14,0.0,2,0
..\DataSets\DelayGraph_36.graphml,8,6,14,0.0,2,0
..\DataSets\DelayGraph_37.graphml,8,6,14,0.0,2,0
..\DataSets\DelayGraph_38.graphml,8,6,14,0.0,2,0
..\DataSets\DelayGraph_39.graphml,8,6,14,0.0,2,0
..\DataSets\DelayGraph_40.graphml,8,6,14,0.0,2,0
..\DataSets\DelayGraph_41.graphml,8,6,14,0.0,2,0
..\DataSets\DelayGraph_42.graphml,8,6,14,0.0,2,0
..\DataSets\DelayGraph_43.graphml,8,6,14,0.0,2,0
..\DataSets\DelayGraph_44.graphml,8,6,14,0.0,2,0
..\DataSets\DelayGraph_45.graphml,8,6,14,0.0,2,0
..\DataSets\DelayGraph_46.graphml,8,6,14,0.0,2,0
..\DataSets\DelayGraph_47.graphml,8,6,14,0.0,2,0
..\DataSets\DelayGraph_48.graphml,8,6,14,0.0,2,0
..\DataSets\DelayGraph_49.graphml,8,6,14,0.0,2,0
..\DataSets\DelayGraph_50.graphml,8,6,14,0.0,2,0
..\DataSets\DelayGraph_51.graphml,8,6,14,0.0,2,0
..\DataSets\DelayGraph_52.graphml,8,6,14,0.0,2,0
..\DataSets\DelayGraph_53.graphml,8,6,14,0.0,2,0
..\DataSets\DelayGraph_54.graphml,8,6,14,0.0,2,0
..\DataSets\DelayGraph_55.graphml,8,6,14,0.0,2,0
..\DataSets\DelayGraph_56.graphml,8,6,14,0.0,2,0
..\DataSets\DelayGraph_57.graphml,8,6,14,0.0,2,0
..\DataSets\DelayGraph_58.graphml,8,6,14,0.0,2,0
..\DataSets\DelayGraph_59.graphml,8,6,14,0.0,2,0
..\DataSets\DelayGraph_60.graphml,8,6,14,0.0,2,0
..\DataSets\DelayGraph_61.graphml,8,6,14,0.0,2,0
..\DataSets\DelayGraph_62.graphml,8,6,14,0.0,2,0
..\DataSets\DelayGraph_63.graphml,8,6,14,0.0,2,0
..\DataSets\DelayGraph_64.graphml,8,6,14,0.0,2,0
..\DataSets\DelayGraph_65.graphml,8,6,14,0.0,2,0
..\DataSets\DelayGraph_66.graphml,8,6,14,0.0,2,0
..\DataSets\DelayGraph_67.graphml,8,6,14,0.0,2,0
..\DataSets\DelayGraph_68.graphml,8,6,14,0.0,2,0
..\DataSets\DelayGraph_69.graphml,8,6,14,0.0,2,0
..\DataSets\DelayGraph_70.graphml,8,6,14,0.0,2,0
..\DataSets\DelayGraph_71.graphml,8,6,14,0.0,2,0
..\DataSets\DelayGraph_72.graphml,8,6,14,0.0,2,0
..\DataSets\DelayGraph_73.graphml,8,6,14,0.0,2,0
..\DataSets\DelayGraph_74.graphml,8,6,14,0.0,2,0
..\DataSets\DelayGraph_75.graphml,8,6,14,0.0,2,0
..\DataSets\DelayGraph_76.graphml,8,6,14,0.0,2,0
..\DataSets\DelayGraph_77.graphml,8,6,14,0.0,2,0
..\DataSets\DelayGraph_78.graphml,8,6,14,0.0,2,0
..\DataSets\DelayGraph_79.graphml,302,353,655,0.0,751,12
..\DataSets\DelayGraph_80.graphml,302,353,655,0.0,751,12
..\DataSets\DelayGraph_81.graphml,212,250,462,0.0,734,8
..\DataSets\DelayGraph_82.graphml,212,250,462,0.0,734,8
..\DataSets\DelayGraph_83.graphml,120,134,254,0.0,130,3
..\DataSets\DelayGraph_86.graphml,118,138,256,0.0,150,5
..\DataSets\DelayGraph_87.graphml,171,201,372,0.0,532,10
..\DataSets\DelayGraph_93.graphml,113,133,246,0.0,57,12
..\DataSets\DelayGraph_97.graphml,61,69,130,0.0,11,6
..\DataSets\DelayGraph_98.graphml,120,134,254,0.0,130,3
..\DataSets\DelayGraph_99.graphml,111,125,236,0.0,130,3
..\DataSets\DelayGraph_103.graphml,118,138,256,0.0,150,5
..\DataSets\DelayGraph_109.graphml,61,69,130,0.0,11,6
..\DataSets\DelayGraph_112.graphml,111,125,236,0.0,130,3
..\DataSets\DelayGraph_113.graphml,1873,2422,4295,0.0,693,806
..\DataSets\DelayGraph_116.graphml,1403,1864,3267,0.0,506,74
..\DataSets\DelayGraph_119.graphml,8,6,14,0.0,2,0
..\DataSets\DelayGraph_120.graphml,8,6,14,0.0,2,0
..\DataSets\DelayGraph_121.graphml,8,6,14,0.0,2,0
..\DataSets\DelayGraph_122.graphml,8,6,14,0.0,2,0
..\DataSets\DelayGraph_123.graphml,8,6,14,0.0,2,0
..\DataSets\DelayGraph_124.graphml,8,6,14,0.0,2,0
..\DataSets\DelayGraph_125.graphml,8,6,14,0.0,2,0
..\DataSets\DelayGraph_126.graphml,8,6,14,0.0,2,0
..\DataSets\DelayGraph_127.graphml,8,6,14,0.0,2,0
..\DataSets\DelayGraph_128.graphml,8,6,14,0.0,2,0
..\DataSets\DelayGraph_129.graphml,8,6,14,0.0,2,0
..\DataSets\DelayGraph_130.graphml,8,6,14,0.0,2,0
..\DataSets\DelayGraph_131.graphml,8,6,14,0.0,2,0
..\DataSets\DelayGraph_132.graphml,8,6,14,0.0,2,0
..\DataSets\DelayGraph_133.graphml,8,6,14,0.0,2,0
..\DataSets\DelayGraph_134.graphml,8,6,14,0.0,2,0
..\DataSets\DelayGraph_135.graphml,8,6,14,0.0,2,0
..\DataSets\DelayGraph_136.graphml,8,6,14,0.0,2,0
..\DataSets\DelayGraph_137.graphml,8,6,14,0.0,2,0
..\DataSets\DelayGraph_138.graphml,8,6,14,0.0,2,0
..\DataSets\DelayGraph_139.graphml,8,6,14,0.0,2,0
..\DataSets\DelayGraph_140.graphml,8,6,14,0.0,2,0
..\DataSets\DelayGraph_141.graphml,8,6,14,0.0,2,0
..\DataSets\DelayGraph_142.graphml,8,6,14,0.0,2,0
..\DataSets\DelayGraph_143.graphml,8,6,14,0.0,2,0
..\DataSets\DelayGraph_144.graphml,8,6,14,0.0,2,0
..\DataSets\DelayGraph_145.graphml,8,6,14,0.0,2,0
..\DataSets\DelayGraph_146.graphml,8,6,14,0.0,2,0
..\DataSets\DelayGraph_147.graphml,8,6,14,0.0,2,0
..\DataSets\DelayGraph_148.graphml,8,6,14,0.0,2,0
..\DataSets\DelayGraph_149.graphml,8,6,14,0.0,2,0
..\DataSets\DelayGraph_150.graphml,8,6,14,0.0,2,0
..\DataSets\DelayGraph_151.graphml,8,6,14,0.0,2,0
..\DataSets\DelayGraph_152.graphml,8,6,14,0.0,2,0
..\DataSets\DelayGraph_153.graphml,8,6,14,0.0,2,0
..\DataSets\DelayGraph_154.graphml,8,6,14,0.0,2,0
..\DataSets\DelayGraph_155.graphml,8,6,14,0.0,2,0
..\DataSets\DelayGraph_156.graphml,8,6,14,0.0,2,0
..\DataSets\DelayGraph_157.graphml,8,6,14,0.0,2,0
..\DataSets\DelayGraph_158.graphml,8,6,14,0.0,2,0
..\DataSets\DelayGraph_159.graphml,8,6,14,0.0,2,0
..\DataSets\DelayGraph_160.graphml,8,6,14,0.0,2,0
..\DataSets\DelayGraph_161.graphml,8,6,14,0.0,2,0
..\DataSets\DelayGraph_162.graphml,8,6,14,0.0,2,0
..\DataSets\DelayGraph_163.graphml,8,6,14,0.0,2,0
..\DataSets\DelayGraph_164.graphml,8,6,14,0.0,2,0
..\DataSets\DelayGraph_165.graphml,8,6,14,0.0,2,0
..\DataSets\DelayGraph_166.graphml,8,6,14,0.0,2,0
..\DataSets\DelayGraph_167.graphml,8,6,14,0.0,2,0
..\DataSets\DelayGraph_168.graphml,8,6,14,0.0,2,0
..\DataSets\DelayGraph_169.graphml,302,353,655,0.0,751,12
..\DataSets\DelayGraph_170.graphml,302,353,655,0.0,751,12
..\DataSets\DelayGraph_171.graphml,48,51,99,0.0,28,0
..\DataSets\DelayGraph_174.graphml,145,167,312,0.0,274,5
..\DataSets\DelayGraph_177.graphml,121,143,264,0.0,51,11
..\DataSets\DelayGraph_180.graphml,48,51,99,0.0,28,0
..\DataSets\DelayGraph_181.graphml,1612,2088,3700,0.0,161,106
..\DataSets\DelayGraph_182.graphml,1901,2448,4349,0.015599966049194336,693,806
..\DataSets\DelayGraph_186.graphml,1403,1864,3267,0.0,506,74
..\DataSets\DelayGraph_187.graphml,6827,8692,15519,0.017600059509277344,777,781
..\DataSets\DelayGraph_190.graphml,8,6,14,0.0,2,0
..\DataSets\DelayGraph_191.graphml,8,6,14,0.0,2,0
..\DataSets\DelayGraph_192.graphml,8,6,14,0.0,2,0
..\DataSets\DelayGraph_193.graphml,8,6,14,0.0,2,0
..\DataSets\DelayGraph_194.graphml,8,6,14,0.0,2,0
..\DataSets\DelayGraph_195.graphml,8,6,14,0.0,2,0
..\DataSets\DelayGraph_196.graphml,8,6,14,0.0,2,0
..\DataSets\DelayGraph_197.graphml,8,6,14,0.0,2,0
..\DataSets\DelayGraph_198.graphml,8,6,14,0.0,2,0
..\DataSets\DelayGraph_199.graphml,8,6,14,0.0,2,0
..\DataSets\DelayGraph_200.graphml,8,6,14,0.0,2,0
..\DataSets\DelayGraph_201.graphml,8,6,14,0.0,2,0
..\DataSets\DelayGraph_202.graphml,8,6,14,0.0,2,0
..\DataSets\DelayGraph_203.graphml,8,6,14,0.0,2,0
..\DataSets\DelayGraph_204.graphml,8,6,14,0.0,2,0
..\DataSets\DelayGraph_205.graphml,8,6,14,0.0,2,0
..\DataSets\DelayGraph_206.graphml,8,6,14,0.0,2,0
..\DataSets\DelayGraph_207.graphml,8,6,14,0.0,2,0
..\DataSets\DelayGraph_208.graphml,8,6,14,0.0,2,0
..\DataSets\DelayGraph_209.graphml,8,6,14,0.0,2,0
..\DataSets\DelayGraph_210.graphml,8,6,14,0.0,2,0
..\DataSets\DelayGraph_211.graphml,8,6,14,0.0,2,0
..\DataSets\DelayGraph_212.graphml,8,6,14,0.0,2,0
..\DataSets\DelayGraph_213.graphml,8,6,14,0.0,2,0
..\DataSets\DelayGraph_214.graphml,8,6,14,0.0,2,0
..\DataSets\DelayGraph_215.graphml,8,6,14,0.0,2,0
..\DataSets\DelayGraph_216.graphml,8,6,14,0.0,2,0
..\DataSets\DelayGraph_217.graphml,8,6,14,0.0,2,0
..\DataSets\DelayGraph_218.graphml,8,6,14,0.0,2,0
..\DataSets\DelayGraph_219.graphml,8,6,14,0.0,2,0
..\DataSets\DelayGraph_220.graphml,8,6,14,0.0,2,0
..\DataSets\DelayGraph_221.graphml,8,6,14,0.0,2,0
..\DataSets\DelayGraph_222.graphml,8,6,14,0.0,2,0
..\DataSets\DelayGraph_223.graphml,8,6,14,0.0,2,0
..\DataSets\DelayGraph_224.graphml,8,6,14,0.0,2,0
..\DataSets\DelayGraph_225.graphml,8,6,14,0.0,2,0
..\DataSets\DelayGraph_226.graphml,8,6,14,0.0,2,0
..\DataSets\DelayGraph_227.graphml,8,6,14,0.0,2,0
..\DataSets\DelayGraph_228.graphml,8,6,14,0.0,2,0
..\DataSets\DelayGraph_229.graphml,8,6,14,0.0,2,0
..\DataSets\DelayGraph_230.graphml,8,6,14,0.0,2,0
..\DataSets\DelayGraph_231.graphml,8,6,14,0.0,2,0
..\DataSets\DelayGraph_232.graphml,8,6,14,0.0,2,0
..\DataSets\DelayGraph_233.graphml,8,6,14,0.0,2,0
..\DataSets\DelayGraph_234.graphml,8,6,14,0.0,2,0
..\DataSets\DelayGraph_235.graphml,8,6,14,0.0,2,0
..\DataSets\DelayGraph_236.graphml,8,6,14,0.0,2,0
..\DataSets\DelayGraph_237.graphml,8,6,14,0.0,2,0
..\DataSets\DelayGraph_238.graphml,8,6,14,0.0,2,0
..\DataSets\DelayGraph_239.graphml,131,141,272,0.0,40,0
..\DataSets\DelayGraph_240.graphml,131,141,272,0.0,40,0
..\DataSets\DelayGraph_241.graphml,90,105,195,0.0,126,1
..\DataSets\DelayGraph_242.graphml,90,105,195,0.0,126,1
..\DataSets\DelayGraph_243.graphml,111,125,236,0.0,130,3
..\DataSets\DelayGraph_246.graphml,171,201,372,0.0,532,10
..\DataSets\DelayGraph_250.graphml,118,138,256,0.0,150,5
..\DataSets\DelayGraph_252.graphml,113,133,246,0.0,57,12
..\DataSets\DelayGraph_257.graphml,61,69,130,0.0,11,6
..\DataSets\DelayGraph_258.graphml,111,125,236,0.0,130,3
..\DataSets\DelayGraph_261.graphml,83,86,169,0.0,28,0
..\DataSets\DelayGraph_263.graphml,145,167,312,0.0,274,5
..\DataSets\DelayGraph_268.graphml,128,150,278,0.0,51,11
..\DataSets\DelayGraph_270.graphml,83,86,169,0.0,28,0
..\DataSets\DelayGraph_271.graphml,48,51,99,0.0,28,0
..\DataSets\DelayGraph_272.graphml,145,167,312,0.0,274,5
..\DataSets\DelayGraph_274.graphml,145,167,312,0.0,274,5
..\DataSets\DelayGraph_275.graphml,121,143,264,0.0,51,11
..\DataSets\DelayGraph_276.graphml,121,143,264,0.0,51,11
..\DataSets\DelayGraph_278.graphml,48,51,99,0.0,28,0
..\DataSets\DelayGraph_280.graphml,1403,1864,3267,0.015599966049194336,506,74
..\DataSets\DelayGraph_283.graphml,8,6,14,0.0,2,0
..\DataSets\DelayGraph_284.graphml,8,6,14,0.0,2,0
..\DataSets\DelayGraph_285.graphml,8,6,14,0.0,2,0
..\DataSets\DelayGraph_286.graphml,8,6,14,0.0,2,0
..\DataSets\DelayGraph_287.graphml,8,6,14,0.0,2,0
..\DataSets\DelayGraph_288.graphml,8,6,14,0.0,2,0
..\DataSets\DelayGraph_289.graphml,8,6,14,0.0,2,0
..\DataSets\DelayGraph_290.graphml,8,6,14,0.0,2,0
..\DataSets\DelayGraph_291.graphml,8,6,14,0.0,2,0
..\DataSets\DelayGraph_292.graphml,8,6,14,0.0,2,0
..\DataSets\DelayGraph_293.graphml,8,6,14,0.0,2,0
..\DataSets\DelayGraph_294.graphml,8,6,14,0.0,2,0
..\DataSets\DelayGraph_295.graphml,8,6,14,0.0,2,0
..\DataSets\DelayGraph_296.graphml,8,6,14,0.0,2,0
..\DataSets\DelayGraph_297.graphml,8,6,14,0.0,2,0
..\DataSets\DelayGraph_298.graphml,8,6,14,0.0,2,0
..\DataSets\DelayGraph_299.graphml,8,6,14,0.0,2,0
..\DataSets\DelayGraph_300.graphml,8,6,14,0.0,2,0
..\DataSets\DelayGraph_301.graphml,8,6,14,0.0,2,0
..\DataSets\DelayGraph_302.graphml,8,6,14,0.0,2,0
..\DataSets\DelayGraph_303.graphml,8,6,14,0.0,2,0
..\DataSets\DelayGraph_304.graphml,8,6,14,0.0,2,0
..\DataSets\DelayGraph_305.graphml,8,6,14,0.0,2,0
..\DataSets\DelayGraph_306.graphml,8,6,14,0.0,2,0
..\DataSets\DelayGraph_307.graphml,8,6,14,0.0,2,0
..\DataSets\DelayGraph_308.graphml,8,6,14,0.0,2,0
..\DataSets\DelayGraph_309.graphml,8,6,14,0.0,2,0
..\DataSets\DelayGraph_310.graphml,8,6,14,0.0,2,0
..\DataSets\DelayGraph_311.graphml,8,6,14,0.0,2,0
..\DataSets\DelayGraph_312.graphml,8,6,14,0.0,2,0
..\DataSets\DelayGraph_313.graphml,8,6,14,0.0,2,0
..\DataSets\DelayGraph_314.graphml,8,6,14,0.0,2,0
..\DataSets\DelayGraph_315.graphml,8,6,14,0.0,2,0
..\DataSets\DelayGraph_316.graphml,8,6,14,0.0,2,0
..\DataSets\DelayGraph_317.graphml,8,6,14,0.0,2,0
..\DataSets\DelayGraph_318.graphml,8,6,14,0.0,2,0
..\DataSets\DelayGraph_319.graphml,8,6,14,0.0,2,0
..\DataSets\DelayGraph_320.graphml,8,6,14,0.0,2,0
..\DataSets\DelayGraph_321.graphml,8,6,14,0.0,2,0
..\DataSets\DelayGraph_322.graphml,8,6,14,0.0,2,0
..\DataSets\DelayGraph_323.graphml,8,6,14,0.0,2,0
..\DataSets\DelayGraph_324.graphml,8,6,14,0.0,2,0
..\DataSets\DelayGraph_325.graphml,8,6,14,0.0,2,0
..\DataSets\DelayGraph_326.graphml,8,6,14,0.0,2,0
..\DataSets\DelayGraph_327.graphml,8,6,14,0.0,2,0
..\DataSets\DelayGraph_328.graphml,8,6,14,0.0,2,0
..\DataSets\DelayGraph_329.graphml,8,6,14,0.0,2,0
..\DataSets\DelayGraph_330.graphml,8,6,14,0.0,2,0
..\DataSets\DelayGraph_331.graphml,8,6,14,0.0,2,0
..\DataSets\DelayGraph_332.graphml,203,241,444,0.0,702,8
..\DataSets\DelayGraph_333.graphml,203,241,444,0.0,702,8
..\DataSets\DelayGraph_336.graphml,8,6,14,0.0,2,0
..\DataSets\DelayGraph_337.graphml,6,4,10,0.0,2,0
..\DataSets\DelayGraph_338.graphml,6,4,10,0.0,2,0
..\DataSets\DelayGraph_339.graphml,23,22,45,0.0,2,0
..\DataSets\DelayGraph_340.graphml,23,22,45,0.0,2,0
..\DataSets\DelayGraph_341.graphml,44,43,87,0.0,9,0
..\DataSets\DelayGraph_342.graphml,44,43,87,0.0,9,0
..\DataSets\DelayGraph_343.graphml,180,210,390,0.0,124,0
..\DataSets\DelayGraph_344.graphml,180,210,390,0.0,124,0
..\DataSets\DelayGraph_345.graphml,89,94,183,0.0,34,0
..\DataSets\DelayGraph_346.graphml,89,94,183,0.0,34,0
..\DataSets\DelayGraph_347.graphml,487,532,1019,0.0,864,0
..\DataSets\DelayGraph_348.graphml,487,532,1019,0.0,864,0
..\DataSets\DelayGraph_349.graphml,1356,1789,3145,0.0,285,362
..\DataSets\DelayGraph_350.graphml,1356,1789,3145,0.015599966049194336,285,362
..\DataSets\DelayGraph_351.graphml,141,143,284,0.0,19,0
..\DataSets\DelayGraph_352.graphml,141,143,284,0.0,19,0
..\DataSets\DelayGraph_355.graphml,41,44,85,0.0,8,1
..\DataSets\DelayGraph_356.graphml,41,44,85,0.0,8,1
..\DataSets\DelayGraph_357.graphml,23,22,45,0.0,2,0
..\DataSets\DelayGraph_358.graphml,23,22,45,0.0,2,0
..\DataSets\DelayGraph_359.graphml,155,174,329,0.0,39,11
..\DataSets\DelayGraph_360.graphml,155,174,329,0.0,39,11
..\DataSets\DelayGraph_361.graphml,1340,1723,3063,0.0,146,371
..\DataSets\DelayGraph_362.graphml,1340,1723,3063,0.0,146,371
..\DataSets\DelayGraph_363.graphml,88,94,182,0.0,24,1
..\DataSets\DelayGraph_364.graphml,88,94,182,0.0,24,1
..\DataSets\DelayGraph_365.graphml,98,101,199,0.0,11,0
..\DataSets\DelayGraph_366.graphml,98,101,199,0.0,11,0
..\DataSets\DelayGraph_367.graphml,8,7,15,0.0,2,0
..\DataSets\DelayGraph_368.graphml,88,94,182,0.0,24,1
..\DataSets\DelayGraph_370.graphml,145,154,299,0.0,7,5
..\DataSets\DelayGraph_371.graphml,145,154,299,0.0,7,5
..\DataSets\DelayGraph_372.graphml,46,44,90,0.0,6,2
..\DataSets\DelayGraph_374.graphml,62,63,125,0.015599966049194336,13,2
..\DataSets\DelayGraph_375.graphml,67,70,137,0.0,24,1
..\DataSets\DelayGraph_376.graphml,43,53,96,0.0,24,0
..\DataSets\DelayGraph_377.graphml,74,94,168,0.0,62,0
..\DataSets\DelayGraph_378.graphml,74,94,168,0.0,62,0
..\DataSets\DelayGraph_379.graphml,86,87,173,0.0,12,4
..\DataSets\DelayGraph_380.graphml,86,87,173,0.0,12,4
..\DataSets\DelayGraph_381.graphml,86,87,173,0.0,12,4
..\DataSets\DelayGraph_382.graphml,126,135,261,0.0,32,8
..\DataSets\DelayGraph_383.graphml,126,135,261,0.0,32,8
..\DataSets\DelayGraph_384.graphml,90,90,180,0.0,18,3
..\DataSets\DelayGraph_385.graphml,198,222,420,0.0,60,0
..\DataSets\DelayGraph_386.graphml,198,222,420,0.0,60,0
..\DataSets\DelayGraph_387.graphml,87,87,174,0.0,21,4
..\DataSets\DelayGraph_388.graphml,204,223,427,0.0,333,0
..\DataSets\DelayGraph_389.graphml,204,223,427,0.0010001659393310547,333,0
..\DataSets\DelayGraph_390.graphml,193,204,397,0.0,5,9
..\DataSets\DelayGraph_391.graphml,238,250,488,0.0,4,8
..\DataSets\DelayGraph_392.graphml,330,360,690,0.0,23,4
..\DataSets\DelayGraph_393.graphml,392,416,808,0.0,25,11
..\DataSets\DelayGraph_394.graphml,347,370,717,0.0,26,12
..\DataSets\DelayGraph_395.graphml,285,314,599,0.0,24,5
..\DataSets\DelayGraph_397.graphml,63,71,134,0.0,11,6
..\DataSets\DelayGraph_403.graphml,116,135,251,0.0,57,12
..\DataSets\DelayGraph_405.graphml,238,250,488,0.0,4,8
..\DataSets\DelayGraph_410.graphml,31,32,63,0.0,5,0
..\DataSets\DelayGraph_413.graphml,84,83,167,0.0,3,0
..\DataSets\DelayGraph_414.graphml,84,83,167,0.0,3,0
..\DataSets\DelayGraph_415.graphml,185,185,370,0.0,14,0
..\DataSets\DelayGraph_416.graphml,185,185,370,0.0,14,0
..\DataSets\DelayGraph_417.graphml,192,201,393,0.0,40,6
..\DataSets\DelayGraph_418.graphml,563,587,1150,0.0,137,12
..\DataSets\DelayGraph_419.graphml,120,137,257,0.0,50,2
..\DataSets\DelayGraph_420.graphml,120,137,257,0.0,50,2
..\DataSets\DelayGraph_421.graphml,211,225,436,0.0,64,8
..\DataSets\DelayGraph_422.graphml,215,280,495,0.0,190,0
..\DataSets\DelayGraph_423.graphml,215,280,495,0.0,190,0
..\DataSets\DelayGraph_424.graphml,311,329,640,0.0,80,25
..\DataSets\DelayGraph_425.graphml,336,374,710,0.0,100,0
..\DataSets\DelayGraph_426.graphml,336,374,710,0.0,100,0
..\DataSets\DelayGraph_427.graphml,590,639,1229,0.0,168,24
..\DataSets\DelayGraph_428.graphml,586,797,1383,0.0009999275207519531,420,0
..\DataSets\DelayGraph_429.graphml,586,797,1383,0.0,420,0
..\DataSets\DelayGraph_430.graphml,124,122,246,0.0,7,0
..\DataSets\DelayGraph_431.graphml,124,122,246,0.0,7,0
..\DataSets\DelayGraph_433.graphml,149,176,325,0.0,287,5
..\DataSets\DelayGraph_436.graphml,126,147,273,0.0,274,5
..\DataSets\DelayGraph_443.graphml,63,71,134,0.0,11,6
..\DataSets\DelayGraph_444.graphml,124,122,246,0.0,7,0
..\DataSets\DelayGraph_445.graphml,438,476,914,0.0,131,28
..\DataSets\DelayGraph_446.graphml,189,219,408,0.0,94,84
..\DataSets\DelayGraph_447.graphml,192,210,402,0.0,66,0
..\DataSets\DelayGraph_448.graphml,192,210,402,0.0,66,0
..\DataSets\DelayGraph_449.graphml,35,36,71,0.0,3,8
..\DataSets\DelayGraph_450.graphml,18,17,35,0.0,3,0
..\DataSets\DelayGraph_451.graphml,78,80,158,0.0,14,0
..\DataSets\DelayGraph_452.graphml,613,730,1343,0.0,233,660
..\DataSets\DelayGraph_456.graphml,210,219,429,0.0010001659393310547,40,6
..\DataSets\DelayGraph_457.graphml,1901,2448,4349,0.015599966049194336,693,806
..\DataSets\DelayGraph_458.graphml,378,407,785,0.0,96,21
..\DataSets\DelayGraph_459.graphml,193,192,385,0.015599966049194336,33,3
..\DataSets\DelayGraph_460.graphml,66,74,140,0.0,11,3
..\DataSets\DelayGraph_461.graphml,66,74,140,0.0,11,3
..\DataSets\DelayGraph_462.graphml,130,142,272,0.0,18,9
..\DataSets\DelayGraph_463.graphml,92,99,191,0.0,9,8
..\DataSets\DelayGraph_464.graphml,92,99,191,0.0,9,8
..\DataSets\DelayGraph_466.graphml,54,59,113,0.0,34,0
..\DataSets\DelayGraph_469.graphml,107,104,211,0.0,19,1
..\DataSets\DelayGraph_470.graphml,107,104,211,0.0,19,1
..\DataSets\DelayGraph_471.graphml,344,362,706,0.0,126,5
..\DataSets\DelayGraph_475.graphml,383,426,809,0.0,285,19
..\DataSets\DelayGraph_479.graphml,31,35,66,0.0,9,2
..\DataSets\DelayGraph_480.graphml,278,303,581,0.0,91,9
..\DataSets\DelayGraph_481.graphml,278,303,581,0.0,91,9
..\DataSets\DelayGraph_482.graphml,33,33,66,0.0,8,0
..\DataSets\DelayGraph_483.graphml,33,33,66,0.0,8,0
..\DataSets\DelayGraph_484.graphml,92,90,182,0.0,15,1
..\DataSets\DelayGraph_485.graphml,92,90,182,0.0,15,1
..\DataSets\DelayGraph_486.graphml,324,381,705,0.0,4,7
..\DataSets\DelayGraph_487.graphml,324,381,705,0.0,4,7
..\DataSets\DelayGraph_496.graphml,117,137,254,0.0,150,5
..\DataSets\DelayGraph_500.graphml,63,71,134,0.0,11,6
..\DataSets\DelayGraph_504.graphml,35,34,69,0.0,8,0
..\DataSets\DelayGraph_505.graphml,88,94,182,0.0,24,1
..\DataSets\DelayGraph_506.graphml,131,145,276,0.0,28,22
..\DataSets\DelayGraph_507.graphml,496,519,1015,0.0,553,9
..\DataSets\DelayGraph_509.graphml,627,681,1308,0.0,596,91
..\DataSets\DelayGraph_510.graphml,627,681,1308,0.0,596,91
..\DataSets\DelayGraph_511.graphml,104,107,211,0.0,21,5
..\DataSets\DelayGraph_514.graphml,319,347,666,0.0,69,21
..\DataSets\DelayGraph_515.graphml,319,347,666,0.0,69,21
..\DataSets\DelayGraph_516.graphml,156,166,322,0.0,35,6
..\DataSets\DelayGraph_517.graphml,304,415,719,0.0,180,0
..\DataSets\DelayGraph_518.graphml,304,415,719,0.0,180,0
..\DataSets\DelayGraph_519.graphml,1016,1080,2096,0.0,336,36
..\DataSets\DelayGraph_520.graphml,485,576,1061,0.0,200,0
..\DataSets\DelayGraph_521.graphml,485,576,1061,0.0,200,0
..\DataSets\DelayGraph_522.graphml,540,537,1077,0.0,187,0
..\DataSets\DelayGraph_525.graphml,525,632,1157,0.0,387,40
..\DataSets\DelayGraph_528.graphml,19,18,37,0.0,4,1
..\DataSets\DelayGraph_529.graphml,79,86,165,0.0,12,9
..\DataSets\DelayGraph_531.graphml,381,442,823,0.0,91,0
..\DataSets\DelayGraph_532.graphml,381,442,823,0.0,91,0
..\DataSets\DelayGraph_533.graphml,212,228,440,0.0,37,0
..\DataSets\DelayGraph_534.graphml,210,219,429,0.0,40,6
..\DataSets\DelayGraph_535.graphml,118,122,240,0.0,21,12
..\DataSets\DelayGraph_536.graphml,31,32,63,0.0,5,3
..\DataSets\DelayGraph_537.graphml,31,32,63,0.0,5,3
..\DataSets\DelayGraph_538.graphml,130,128,258,0.0,36,2
..\DataSets\DelayGraph_540.graphml,63,71,134,0.0,11,6
..\DataSets\DelayGraph_541.graphml,116,135,251,0.0,57,12
..\DataSets\DelayGraph_547.graphml,443,459,902,0.0,86,16
..\DataSets\DelayGraph_548.graphml,137,133,270,0.0,17,3
..\DataSets\DelayGraph_549.graphml,139,149,288,0.0,19,9
..\DataSets\DelayGraph_550.graphml,139,149,288,0.0,19,9
..\DataSets\DelayGraph_551.graphml,81,89,170,0.0,15,2
..\DataSets\DelayGraph_552.graphml,81,89,170,0.0,15,2
..\DataSets\DelayGraph_553.graphml,23,23,46,0.0,6,1
..\DataSets\DelayGraph_554.graphml,137,139,276,0.0,19,0
..\DataSets\DelayGraph_557.graphml,33,36,69,0.0,6,0
..\DataSets\DelayGraph_558.graphml,170,181,351,0.0,4,5
..\DataSets\DelayGraph_559.graphml,26,25,51,0.0,7,0
..\DataSets\DelayGraph_560.graphml,3,2,5,0.0,1,0
..\DataSets\DelayGraph_561.graphml,3,2,5,0.0,1,0
..\DataSets\DelayGraph_562.graphml,25,23,48,0.0,5,0
..\DataSets\DelayGraph_563.graphml,25,23,48,0.0,5,0
..\DataSets\DelayGraph_564.graphml,48,42,90,0.0,11,1
..\DataSets\DelayGraph_565.graphml,75,79,154,0.0,22,2
..\DataSets\DelayGraph_566.graphml,487,542,1029,0.0,336,24
..\DataSets\DelayGraph_567.graphml,487,542,1029,0.0,336,24
..\DataSets\DelayGraph_568.graphml,13,12,25,0.0,3,0
..\DataSets\DelayGraph_569.graphml,13,12,25,0.0,3,0
..\DataSets\DelayGraph_570.graphml,28,27,55,0.0,2,0
..\DataSets\DelayGraph_571.graphml,150,177,327,0.0,287,5
..\DataSets\DelayGraph_573.graphml,150,177,327,0.0,287,5
..\DataSets\DelayGraph_574.graphml,28,27,55,0.0,2,0
..\DataSets\DelayGraph_576.graphml,3822,4148,7970,0.015599966049194336,298,61
..\DataSets\DelayGraph_577.graphml,10,9,19,0.0,1,0
..\DataSets\DelayGraph_578.graphml,10,9,19,0.0,1,0
..\DataSets\DelayGraph_579.graphml,943,1007,1950,0.0,510,931
..\DataSets\DelayGraph_580.graphml,943,1007,1950,0.0,510,931
..\DataSets\DelayGraph_581.graphml,63,66,129,0.0,18,3
..\DataSets\DelayGraph_582.graphml,99,110,209,0.0,46,2
..\DataSets\DelayGraph_583.graphml,99,110,209,0.0,46,2
..\DataSets\DelayGraph_584.graphml,98,104,202,0.0,8,6
..\DataSets\DelayGraph_585.graphml,18,17,35,0.0,3,0
..\DataSets\DelayGraph_586.graphml,236,245,481,0.0,51,10
..\DataSets\DelayGraph_587.graphml,224,267,491,0.0,105,0
..\DataSets\DelayGraph_588.graphml,224,267,491,0.0,105,0
..\DataSets\DelayGraph_589.graphml,86,81,167,0.0,13,0
..\DataSets\DelayGraph_590.graphml,86,81,167,0.0,13,0
..\DataSets\DelayGraph_591.graphml,86,81,167,0.0,13,0
..\DataSets\DelayGraph_592.graphml,505,560,1065,0.0,145,11
..\DataSets\DelayGraph_593.graphml,1328,1593,2921,0.0,560,0
..\DataSets\DelayGraph_594.graphml,1328,1593,2921,0.0,560,0
..\DataSets\DelayGraph_595.graphml,123,139,262,0.0,57,0
..\DataSets\DelayGraph_596.graphml,123,139,262,0.0,57,0
..\DataSets\DelayGraph_597.graphml,123,139,262,0.0,57,0
..\DataSets\DelayGraph_598.graphml,89,87,176,0.0,13,0
..\DataSets\DelayGraph_599.graphml,89,87,176,0.0,13,0
..\DataSets\DelayGraph_600.graphml,89,87,176,0.0,13,0
..\DataSets\DelayGraph_601.graphml,157,159,316,0.0,15,6
..\DataSets\DelayGraph_602.graphml,604,699,1303,0.015599966049194336,196,0
..\DataSets\DelayGraph_603.graphml,604,699,1303,0.0,196,0
..\DataSets\DelayGraph_608.graphml,273,315,588,0.0,296,40
..\DataSets\DelayGraph_611.graphml,543,633,1176,0.015599966049194336,372,40
..\DataSets\DelayGraph_614.graphml,163,175,338,0.0,51,17
..\DataSets\DelayGraph_615.graphml,174,182,356,0.0,50,0
..\DataSets\DelayGraph_616.graphml,174,182,356,0.0,50,0
..\DataSets\DelayGraph_617.graphml,731,801,1532,0.0,172,0
..\DataSets\DelayGraph_618.graphml,1403,1864,3267,0.0,506,74
..\DataSets\DelayGraph_626.graphml,63,71,134,0.0,11,6
..\DataSets\DelayGraph_627.graphml,116,135,251,0.0,57,12
..\DataSets\DelayGraph_629.graphml,447,463,910,0.0,86,16
..\DataSets\DelayGraph_630.graphml,39,34,73,0.0,7,0
..\DataSets\DelayGraph_631.graphml,244,248,492,0.0,35,7
..\DataSets\DelayGraph_632.graphml,71,77,148,0.0,11,8
..\DataSets\DelayGraph_633.graphml,8,7,15,0.0,2,0
..\DataSets\DelayGraph_634.graphml,8,7,15,0.0,2,0
..\DataSets\DelayGraph_635.graphml,122,144,266,0.0,141,4
..\DataSets\DelayGraph_636.graphml,49,53,102,0.0,12,0
..\DataSets\DelayGraph_637.graphml,49,53,102,0.0,12,0
..\DataSets\DelayGraph_638.graphml,22,20,42,0.0,3,0
..\DataSets\DelayGraph_639.graphml,22,20,42,0.0,3,0
..\DataSets\DelayGraph_640.graphml,132,143,275,0.0,41,6
..\DataSets\DelayGraph_643.graphml,64,69,133,0.0,20,2
..\DataSets\DelayGraph_644.graphml,32,35,67,0.0,14,0
..\DataSets\DelayGraph_645.graphml,32,35,67,0.0,14,0
..\DataSets\DelayGraph_646.graphml,42,53,95,0.015599966049194336,29,0
..\DataSets\DelayGraph_647.graphml,42,53,95,0.0,29,0
..\DataSets\DelayGraph_648.graphml,155,162,317,0.0,20,7
..\DataSets\DelayGraph_649.graphml,155,162,317,0.0,20,7
..\DataSets\DelayGraph_650.graphml,133,139,272,0.0,16,6
..\DataSets\DelayGraph_651.graphml,133,139,272,0.0,16,6
..\DataSets\DelayGraph_652.graphml,144,143,287,0.0,1,0
..\DataSets\DelayGraph_653.graphml,61,69,130,0.0,11,6
..\DataSets\DelayGraph_655.graphml,61,69,130,0.0,11,6
..\DataSets\DelayGraph_656.graphml,144,143,287,0.0,1,0
..\DataSets\DelayGraph_657.graphml,170,186,356,0.0,47,8
..\DataSets\DelayGraph_661.graphml,126,148,274,0.0,51,11
..\DataSets\DelayGraph_665.graphml,61,69,130,0.0,11,6
..\DataSets\DelayGraph_668.graphml,420,470,890,0.0,404,14
..\DataSets\DelayGraph_671.graphml,74,71,145,0.0,8,0
..\DataSets\DelayGraph_672.graphml,74,71,145,0.0,8,0
..\DataSets\DelayGraph_673.graphml,650,653,1303,0.015600204467773438,13,5
..\DataSets\DelayGraph_674.graphml,7887,7931,15818,0.015600204467773438,137,0
..\DataSets\DelayGraph_675.graphml,2289,2298,4587,0.0,42,4
..\DataSets\DelayGraph_676.graphml,4311,4333,8644,0.031199932098388672,81,7
..\DataSets\DelayGraph_678.graphml,7887,7931,15818,0.015599966049194336,137,0
..\DataSets\DelayGraph_679.graphml,30,24,54,0.0,6,0
..\DataSets\DelayGraph_680.graphml,30,24,54,0.0,6,0
..\DataSets\DelayGraph_681.graphml,328,347,675,0.0,48,50
..\DataSets\DelayGraph_685.graphml,44,44,88,0.0,9,2
..\DataSets\DelayGraph_686.graphml,6,5,11,0.0,1,0
..\DataSets\DelayGraph_687.graphml,26,30,56,0.0,5,2
..\DataSets\DelayGraph_688.graphml,26,30,56,0.0,5,2
..\DataSets\DelayGraph_689.graphml,13,10,23,0.0,2,0
..\DataSets\DelayGraph_690.graphml,13,10,23,0.0,2,0
..\DataSets\DelayGraph_691.graphml,13,10,23,0.0,2,0
..\DataSets\DelayGraph_692.graphml,168,172,340,0.0,36,6
..\DataSets\DelayGraph_693.graphml,355,400,755,0.0009999275207519531,95,0
..\DataSets\DelayGraph_694.graphml,355,400,755,0.0,95,0
..\DataSets\DelayGraph_695.graphml,56,57,113,0.0,13,0
..\DataSets\DelayGraph_696.graphml,56,57,113,0.0,13,0
..\DataSets\DelayGraph_697.graphml,56,57,113,0.0,13,0
..\DataSets\DelayGraph_698.graphml,193,249,442,0.0,22,39
..\DataSets\DelayGraph_699.graphml,193,249,442,0.0,22,39
..\DataSets\DelayGraph_700.graphml,131,131,262,0.0,23,0
..\DataSets\DelayGraph_701.graphml,18,17,35,0.0,3,0
..\DataSets\DelayGraph_702.graphml,53,57,110,0.0,12,0
..\DataSets\DelayGraph_703.graphml,53,57,110,0.0,12,0
..\DataSets\DelayGraph_704.graphml,49,52,101,0.0,10,2
..\DataSets\DelayGraph_707.graphml,137,139,276,0.0,19,0
..\DataSets\DelayGraph_710.graphml,1401,1862,3263,0.0,506,74
..\DataSets\DelayGraph_713.graphml,8,6,14,0.0,2,0
..\DataSets\DelayGraph_714.graphml,8,6,14,0.0,2,0
..\DataSets\DelayGraph_715.graphml,3,2,5,0.0,1,0
..\DataSets\DelayGraph_716.graphml,4179,4178,8357,0.021999835968017578,23,0
..\DataSets\DelayGraph_717.graphml,44,23,67,0.0,21,0
..\DataSets\DelayGraph_718.graphml,12,8,20,0.0,4,0
..\DataSets\DelayGraph_719.graphml,12,8,20,0.0,4,0
..\DataSets\DelayGraph_720.graphml,44,23,67,0.0,21,0
..\DataSets\DelayGraph_721.graphml,12,8,20,0.0,4,0
..\DataSets\DelayGraph_722.graphml,12,8,20,0.0,4,0
..\DataSets\DelayGraph_723.graphml,44,23,67,0.0,21,0
..\DataSets\DelayGraph_724.graphml,12,8,20,0.0,4,0
..\DataSets\DelayGraph_725.graphml,8,6,14,0.0,2,0
..\DataSets\DelayGraph_726.graphml,44,23,67,0.0,21,0
..\DataSets\DelayGraph_727.graphml,12,8,20,0.0,4,0
..\DataSets\DelayGraph_728.graphml,3,2,5,0.0,1,0
..\DataSets\DelayGraph_729.graphml,3,2,5,0.0,1,0
..\DataSets\DelayGraph_730.graphml,3,2,5,0.0,1,0
..\DataSets\DelayGraph_731.graphml,3,2,5,0.0,1,0
..\DataSets\DelayGraph_732.graphml,3,2,5,0.0,1,0
..\DataSets\DelayGraph_733.graphml,3,2,5,0.0,1,0
..\DataSets\DelayGraph_734.graphml,3,2,5,0.0,1,0
..\DataSets\DelayGraph_735.graphml,80,81,161,0.0,12,0
..\DataSets\DelayGraph_736.graphml,154,158,312,0.0,36,2
..\DataSets\DelayGraph_737.graphml,9,8,17,0.0,2,0
..\DataSets\DelayGraph_738.graphml,428,588,1016,0.0,1000,1
..\DataSets\DelayGraph_739.graphml,428,588,1016,0.0,1000,1
..\DataSets\DelayGraph_740.graphml,359,483,842,0.0,343,0
..\DataSets\DelayGraph_741.graphml,65,63,128,0.0,11,1
..\DataSets\DelayGraph_742.graphml,42,44,86,0.0,15,0
..\DataSets\DelayGraph_743.graphml,112,121,233,0.0,26,7
..\DataSets\DelayGraph_746.graphml,148,170,318,0.0,53,3
..\DataSets\DelayGraph_747.graphml,148,170,318,0.0,53,3
..\DataSets\DelayGraph_748.graphml,92,92,184,0.0,5,5
..\DataSets\DelayGraph_749.graphml,92,92,184,0.0,5,5
..\DataSets\DelayGraph_750.graphml,60,63,123,0.0,14,3
..\DataSets\DelayGraph_751.graphml,78,83,161,0.0,18,8
..\DataSets\DelayGraph_752.graphml,172,182,354,0.0,16,0
..\DataSets\DelayGraph_754.graphml,126,147,273,0.0,274,5
..\DataSets\DelayGraph_755.graphml,126,147,273,0.0,274,5
..\DataSets\DelayGraph_756.graphml,172,182,354,0.0,16,0
..\DataSets\DelayGraph_757.graphml,28,26,54,0.0,6,0
..\DataSets\DelayGraph_758.graphml,28,26,54,0.0,6,0
..\DataSets\DelayGraph_761.graphml,43,42,85,0.0,8,0
..\DataSets\DelayGraph_762.graphml,43,42,85,0.0,8,0
..\DataSets\DelayGraph_763.graphml,58,62,120,0.0,12,0
..\DataSets\DelayGraph_764.graphml,58,62,120,0.0,12,0
..\DataSets\DelayGraph_765.graphml,96,98,194,0.0,10,2
..\DataSets\DelayGraph_766.graphml,96,98,194,0.0,10,2
..\DataSets\DelayGraph_767.graphml,72,76,148,0.0,20,3
..\DataSets\DelayGraph_768.graphml,126,146,272,0.0,56,2
..\DataSets\DelayGraph_769.graphml,126,146,272,0.0,56,2
..\DataSets\DelayGraph_770.graphml,84,89,173,0.0,18,3
..\DataSets\DelayGraph_771.graphml,126,146,272,0.0,54,2
..\DataSets\DelayGraph_772.graphml,126,146,272,0.0,54,2
..\DataSets\DelayGraph_773.graphml,505,535,1040,0.0,312,26
..\DataSets\DelayGraph_775.graphml,353,422,775,0.0,476,0
..\DataSets\DelayGraph_776.graphml,61,69,130,0.0,11,6
..\DataSets\DelayGraph_778.graphml,61,69,130,0.0,11,6
..\DataSets\DelayGraph_781.graphml,353,422,775,0.0,476,0
..\DataSets\DelayGraph_782.graphml,53,48,101,0.0,9,0
..\DataSets\DelayGraph_783.graphml,36,33,69,0.0,8,0
..\DataSets\DelayGraph_784.graphml,36,33,69,0.0,8,0
..\DataSets\DelayGraph_785.graphml,188,185,373,0.0,58,0
..\DataSets\DelayGraph_788.graphml,48,44,92,0.0,6,5
..\DataSets\DelayGraph_793.graphml,53,57,110,0.0,12,0
..\DataSets\DelayGraph_794.graphml,53,57,110,0.0,12,0
..\DataSets\DelayGraph_795.graphml,77,81,158,0.0,11,7
..\DataSets\DelayGraph_796.graphml,156,169,325,0.0,18,0
..\DataSets\DelayGraph_797.graphml,156,169,325,0.0,18,0
..\DataSets\DelayGraph_798.graphml,92,100,192,0.0,14,9
..\DataSets\DelayGraph_799.graphml,131,146,277,0.0,30,10
..\DataSets\DelayGraph_800.graphml,212,228,440,0.0,37,0
..\DataSets\DelayGraph_801.graphml,212,228,440,0.0,37,0
..\DataSets\DelayGraph_803.graphml,1621,2101,3722,0.0,161,466
..\DataSets\DelayGraph_806.graphml,20,20,40,0.0,4,0
..\DataSets\DelayGraph_807.graphml,20,20,40,0.0,4,0
..\DataSets\DelayGraph_809.graphml,116,135,251,0.0,57,12
..\DataSets\DelayGraph_813.graphml,63,71,134,0.0,11,6
..\DataSets\DelayGraph_816.graphml,492,505,997,0.0,94,15
..\DataSets\DelayGraph_817.graphml,130,142,272,0.0,18,9
..\DataSets\DelayGraph_818.graphml,130,142,272,0.0,18,9
..\DataSets\DelayGraph_819.graphml,349,473,822,0.0,244,0
..\DataSets\DelayGraph_820.graphml,81,95,176,0.0,16,0
..\DataSets\DelayGraph_821.graphml,78,83,161,0.0,18,8
..\DataSets\DelayGraph_822.graphml,78,83,161,0.0,8,2
..\DataSets\DelayGraph_823.graphml,78,83,161,0.0,8,2
..\DataSets\DelayGraph_824.graphml,30,22,52,0.0,10,0
..\DataSets\DelayGraph_825.graphml,30,22,52,0.0,10,0
..\DataSets\DelayGraph_826.graphml,40,40,80,0.0,7,2
..\DataSets\DelayGraph_828.graphml,375,393,768,0.0,132,3
..\DataSets\DelayGraph_830.graphml,113,133,246,0.0,57,12
..\DataSets\DelayGraph_832.graphml,61,69,130,0.0,11,6
..\DataSets\DelayGraph_834.graphml,113,133,246,0.0,57,12
..\DataSets\DelayGraph_838.graphml,375,393,768,0.0,132,3
..\DataSets\DelayGraph_839.graphml,80,87,167,0.0,23,2
..\DataSets\DelayGraph_840.graphml,28,28,56,0.0,5,0
..\DataSets\DelayGraph_841.graphml,28,28,56,0.0,5,0
..\DataSets\DelayGraph_842.graphml,146,153,299,0.015599966049194336,18,8
..\DataSets\DelayGraph_843.graphml,146,153,299,0.0,18,8
..\DataSets\DelayGraph_844.graphml,112,121,233,0.0,18,4
..\DataSets\DelayGraph_845.graphml,112,121,233,0.0,18,4
..\DataSets\DelayGraph_846.graphml,112,121,233,0.0,18,4
..\DataSets\DelayGraph_847.graphml,106,108,214,0.0,18,5
..\DataSets\DelayGraph_848.graphml,114,132,246,0.0,26,11
..\DataSets\DelayGraph_852.graphml,106,108,214,0.0,18,5
..\DataSets\DelayGraph_853.graphml,127,145,272,0.0,35,6
..\DataSets\DelayGraph_854.graphml,127,145,272,0.0,35,6
..\DataSets\DelayGraph_855.graphml,127,145,272,0.0,35,6
..\DataSets\DelayGraph_856.graphml,14,12,26,0.0,2,0
..\DataSets\DelayGraph_857.graphml,14,12,26,0.0,2,0
..\DataSets\DelayGraph_862.graphml,2429,2550,4979,0.015599966049194336,393,138
..\DataSets\DelayGraph_867.graphml,127,148,275,0.0,274,5
..\DataSets\DelayGraph_870.graphml,63,71,134,0.0,11,6
..\DataSets\DelayGraph_873.graphml,171,184,355,0.0,30,9
..\DataSets\DelayGraph_874.graphml,7,5,12,0.0,2,0
..\DataSets\DelayGraph_875.graphml,88,94,182,0.0,24,1
..\DataSets\DelayGraph_876.graphml,17,17,34,0.0,2,1
..\DataSets\DelayGraph_877.graphml,80,85,165,0.0,18,8
..\DataSets\DelayGraph_878.graphml,236,245,481,0.0,51,10
..\DataSets\DelayGraph_879.graphml,224,267,491,0.0,105,0
..\DataSets\DelayGraph_880.graphml,224,267,491,0.0,105,0
..\DataSets\DelayGraph_881.graphml,94,96,190,0.015599966049194336,23,3
..\DataSets\DelayGraph_882.graphml,78,95,173,0.0,37,0
..\DataSets\DelayGraph_883.graphml,78,95,173,0.0,37,0
..\DataSets\DelayGraph_884.graphml,262,292,554,0.0009999275207519531,65,14
..\DataSets\DelayGraph_885.graphml,262,292,554,0.0,65,14
..\DataSets\DelayGraph_886.graphml,262,292,554,0.0,65,14
..\DataSets\DelayGraph_887.graphml,310,340,650,0.0,70,22
..\DataSets\DelayGraph_888.graphml,78,84,162,0.0,22,0
..\DataSets\DelayGraph_889.graphml,78,84,162,0.0,22,0
..\DataSets\DelayGraph_890.graphml,193,249,442,0.0,22,39
..\DataSets\DelayGraph_891.graphml,31,33,64,0.0,5,0
..\DataSets\DelayGraph_892.graphml,31,33,64,0.0,5,0
..\DataSets\DelayGraph_893.graphml,43,44,87,0.0,6,1
..\DataSets\DelayGraph_894.graphml,358,402,760,0.0,63,0
..\DataSets\DelayGraph_895.graphml,238,262,500,0.0,27,20
..\DataSets\DelayGraph_896.graphml,107,111,218,0.0,15,2
..\DataSets\DelayGraph_897.graphml,949,1052,2001,0.0,134,75
..\DataSets\DelayGraph_898.graphml,493,545,1038,0.0,66,40
..\DataSets\DelayGraph_899.graphml,493,545,1038,0.0009999275207519531,66,40
..\DataSets\DelayGraph_900.graphml,533,563,1096,0.0,59,0
..\DataSets\DelayGraph_901.graphml,557,587,1144,0.0,59,0
..\DataSets\DelayGraph_902.graphml,20,21,41,0.0,6,0
..\DataSets\DelayGraph_903.graphml,20,21,41,0.0,6,0
..\DataSets\DelayGraph_904.graphml,51,54,105,0.0,12,2
..\DataSets\DelayGraph_907.graphml,11,8,19,0.0,2,0
..\DataSets\DelayGraph_908.graphml,233,242,475,0.0,40,6
..\DataSets\DelayGraph_911.graphml,63,71,134,0.0,11,6
..\DataSets\DelayGraph_913.graphml,116,135,251,0.015599966049194336,57,12
..\DataSets\DelayGraph_918.graphml,443,459,902,0.0,86,16
..\DataSets\DelayGraph_919.graphml,244,248,492,0.0,35,7
..\DataSets\DelayGraph_920.graphml,119,126,245,0.0,21,6
..\DataSets\DelayGraph_921.graphml,95,100,195,0.0,34,0
..\DataSets\DelayGraph_922.graphml,136,153,289,0.0,22,14
..\DataSets\DelayGraph_923.graphml,136,153,289,0.0,22,14
..\DataSets\DelayGraph_924.graphml,666,923,1589,0.0,818,0
..\DataSets\DelayGraph_925.graphml,666,923,1589,0.0,818,0
..\DataSets\DelayGraph_928.graphml,191,252,443,0.0,141,0
..\DataSets\DelayGraph_930.graphml,30,29,59,0.0,8,0
..\DataSets\DelayGraph_931.graphml,119,123,242,0.0,24,7
..\DataSets\DelayGraph_932.graphml,189,196,385,0.0,37,6
..\DataSets\DelayGraph_933.graphml,114,132,246,0.0,26,11
..\DataSets\DelayGraph_937.graphml,119,123,242,0.0,24,7
..\DataSets\DelayGraph_938.graphml,66,69,135,0.0,18,0
..\DataSets\DelayGraph_939.graphml,66,69,135,0.0,18,0
..\DataSets\DelayGraph_940.graphml,92,90,182,0.0,15,1
..\DataSets\DelayGraph_941.graphml,92,90,182,0.0,15,1
..\DataSets\DelayGraph_942.graphml,134,135,269,0.0,12,7
..\DataSets\DelayGraph_943.graphml,134,135,269,0.0,12,7
..\DataSets\DelayGraph_949.graphml,193,204,397,0.0,5,9
..\DataSets\DelayGraph_950.graphml,238,250,488,0.0,4,8
..\DataSets\DelayGraph_951.graphml,330,360,690,0.0,23,4
..\DataSets\DelayGraph_953.graphml,116,135,251,0.0,57,12
..\DataSets\DelayGraph_954.graphml,63,71,134,0.0,11,6
..\DataSets\DelayGraph_960.graphml,330,360,690,0.0,23,4
..\DataSets\DelayGraph_965.graphml,224,262,486,0.0,52,22
..\DataSets\DelayGraph_968.graphml,49,51,100,0.0,15,1
..\DataSets\DelayGraph_969.graphml,1797,1995,3792,0.015599966049194336,200,0
..\DataSets\DelayGraph_970.graphml,1797,1995,3792,0.017600059509277344,200,0
..\DataSets\DelayGraph_971.graphml,35,34,69,0.0,8,0
..\DataSets\DelayGraph_972.graphml,35,34,69,0.0,8,0
..\DataSets\DelayGraph_973.graphml,43,42,85,0.0,8,0
..\DataSets\DelayGraph_974.graphml,43,42,85,0.0,8,0
..\DataSets\DelayGraph_978.graphml,17,16,33,0.0,2,0
..\DataSets\DelayGraph_979.graphml,17,16,33,0.0,2,0
..\DataSets\DelayGraph_980.graphml,327,346,673,0.0,48,50
..\DataSets\DelayGraph_984.graphml,76,84,160,0.0,52,0
..\DataSets\DelayGraph_985.graphml,76,84,160,0.0,52,0
..\DataSets\DelayGraph_986.graphml,42,41,83,0.0,5,1
..\DataSets\DelayGraph_987.graphml,88,94,182,0.0,24,1
..\DataSets\DelayGraph_988.graphml,6,5,11,0.0,1,0
..\DataSets\DelayGraph_989.graphml,28,27,55,0.0,2,0
..\DataSets\DelayGraph_990.graphml,126,148,274,0.0,51,11
..\DataSets\DelayGraph_996.graphml,213,250,463,0.0,196,22
..\DataSets\DelayGraph_997.graphml,28,27,55,0.0,2,0
..\DataSets\DelayGraph_998.graphml,80,85,165,0.0,18,8
..\DataSets\DelayGraph_999.graphml,66,69,135,0.0,16,0
..\DataSets\DelayGraph_1000.graphml,66,69,135,0.0,16,0
..\DataSets\DelayGraph_1001.graphml,66,69,135,0.0,16,0
..\DataSets\DelayGraph_1002.graphml,705,793,1498,0.0,231,25
..\DataSets\DelayGraph_1003.graphml,705,793,1498,0.0,231,25
..\DataSets\DelayGraph_1004.graphml,279,306,585,0.0,74,14
..\DataSets\DelayGraph_1005.graphml,289,330,619,0.0,102,12
..\DataSets\DelayGraph_1006.graphml,106,135,241,0.0,72,0
..\DataSets\DelayGraph_1007.graphml,106,135,241,0.0,72,0
..\DataSets\DelayGraph_1008.graphml,15,13,28,0.0,3,0
..\DataSets\DelayGraph_1009.graphml,50,53,103,0.0,10,2
..\DataSets\DelayGraph_1012.graphml,24,25,49,0.0,6,2
..\DataSets\DelayGraph_1013.graphml,66,72,138,0.0,20,0
..\DataSets\DelayGraph_1014.graphml,172,189,361,0.0,21,2
..\DataSets\DelayGraph_1021.graphml,63,71,134,0.0,11,6
..\DataSets\DelayGraph_1022.graphml,116,135,251,0.0,57,12
..\DataSets\DelayGraph_1023.graphml,475,488,963,0.0,93,15
..\DataSets\DelayGraph_1024.graphml,63,71,134,0.0,11,6
..\DataSets\DelayGraph_1031.graphml,116,135,251,0.0,57,12
..\DataSets\DelayGraph_1032.graphml,447,463,910,0.0,86,16
..\DataSets\DelayGraph_1033.graphml,48,47,95,0.0,11,3
..\DataSets\DelayGraph_1034.graphml,48,47,95,0.0,11,3
..\DataSets\DelayGraph_1035.graphml,210,219,429,0.0,40,6
..\DataSets\DelayGraph_1036.graphml,103,116,219,0.0,260,0
..\DataSets\DelayGraph_1037.graphml,249,293,542,0.0,168,0
..\DataSets\DelayGraph_1038.graphml,249,293,542,0.0,168,0
..\DataSets\DelayGraph_1039.graphml,50,62,112,0.0,33,0
..\DataSets\DelayGraph_1040.graphml,85,94,179,0.0,17,4
..\DataSets\DelayGraph_1041.graphml,85,94,179,0.0,17,4
..\DataSets\DelayGraph_1042.graphml,34,39,73,0.0,17,0
..\DataSets\DelayGraph_1043.graphml,34,39,73,0.0,17,0
..\DataSets\DelayGraph_1044.graphml,305,328,633,0.0,94,8
..\DataSets\DelayGraph_1045.graphml,305,328,633,0.0,94,8
..\DataSets\DelayGraph_1046.graphml,123,136,259,0.0,21,8
..\DataSets\DelayGraph_1047.graphml,123,136,259,0.0,21,8
..\DataSets\DelayGraph_1048.graphml,123,136,259,0.0,21,8
..\DataSets\DelayGraph_1053.graphml,69,70,139,0.0,8,1
..\DataSets\DelayGraph_1054.graphml,1053,1082,2135,0.031199932098388672,125,0
..\DataSets\DelayGraph_1055.graphml,1053,1082,2135,0.0,125,0
..\DataSets\DelayGraph_1056.graphml,463,511,974,0.0,399,14
..\DataSets\DelayGraph_1059.graphml,1612,2088,3700,0.0,161,106
..\DataSets\DelayGraph_1062.graphml,1901,2448,4349,0.0,693,806
..\DataSets\DelayGraph_1063.graphml,1901,2448,4349,0.0,693,806
..\DataSets\DelayGraph_1064.graphml,172,183,355,0.0,4,5
..\DataSets\DelayGraph_1065.graphml,139,149,288,0.0,16,0
..\DataSets\DelayGraph_1066.graphml,126,147,273,0.0,274,5
..\DataSets\DelayGraph_1068.graphml,126,147,273,0.0,274,5
..\DataSets\DelayGraph_1069.graphml,139,149,288,0.0,16,0
..\DataSets\DelayGraph_1070.graphml,47,47,94,0.0,8,2
..\DataSets\DelayGraph_1071.graphml,188,199,387,0.0,14,8
..\DataSets\DelayGraph_1072.graphml,99,104,203,0.0,24,3
..\DataSets\DelayGraph_1073.graphml,298,383,681,0.0,190,0
..\DataSets\DelayGraph_1074.graphml,298,383,681,0.0,190,0
..\DataSets\DelayGraph_1075.graphml,88,94,182,0.0,24,1
..\DataSets\DelayGraph_1076.graphml,38,37,75,0.0,4,0
..\DataSets\DelayGraph_1079.graphml,183,214,397,0.0,167,13
..\DataSets\DelayGraph_1081.graphml,38,37,75,0.0,4,0
..\DataSets\DelayGraph_1082.graphml,41,39,80,0.0,10,0
..\DataSets\DelayGraph_1083.graphml,71,68,139,0.0,12,0
..\DataSets\DelayGraph_1084.graphml,71,68,139,0.0,12,0
..\DataSets\DelayGraph_1085.graphml,71,68,139,0.0,12,0
..\DataSets\DelayGraph_1086.graphml,178,201,379,0.0,64,6
..\DataSets\DelayGraph_1087.graphml,175,196,371,0.0,61,0
..\DataSets\DelayGraph_1088.graphml,175,196,371,0.0,61,0
..\DataSets\DelayGraph_1089.graphml,169,171,340,0.0,47,0
..\DataSets\DelayGraph_1090.graphml,169,171,340,0.0,47,0
..\DataSets\DelayGraph_1091.graphml,169,171,340,0.0,47,0
..\DataSets\DelayGraph_1092.graphml,261,283,544,0.0,63,14
..\DataSets\DelayGraph_1093.graphml,522,595,1117,0.0,273,28
..\DataSets\DelayGraph_1094.graphml,54,63,117,0.0,28,0
..\DataSets\DelayGraph_1095.graphml,54,63,117,0.0,28,0
..\DataSets\DelayGraph_1096.graphml,363,370,733,0.0,89,0
..\DataSets\DelayGraph_1099.graphml,70,67,137,0.015599966049194336,7,0
..\DataSets\DelayGraph_1100.graphml,70,67,137,0.0,7,0
..\DataSets\DelayGraph_1101.graphml,110,128,238,0.0,26,11
..\DataSets\DelayGraph_1107.graphml,153,182,335,0.0010001659393310547,87,13
..\DataSets\DelayGraph_1111.graphml,124,146,270,0.0,51,11
..\DataSets\DelayGraph_1114.graphml,110,128,238,0.0,26,11
..\DataSets\DelayGraph_1117.graphml,70,67,137,0.0,7,0
..\DataSets\DelayGraph_1118.graphml,30,28,58,0.0,4,3
..\DataSets\DelayGraph_1119.graphml,157,162,319,0.0,17,0
..\DataSets\DelayGraph_1120.graphml,109,122,231,0.0,37,9
..\DataSets\DelayGraph_1123.graphml,127,140,267,0.0,43,9
..\DataSets\DelayGraph_1126.graphml,89,96,185,0.0,14,8
..\DataSets\DelayGraph_1128.graphml,1427,1569,2996,0.015599966049194336,380,0
..\DataSets\DelayGraph_1129.graphml,1427,1569,2996,0.0,380,0
..\DataSets\DelayGraph_1130.graphml,89,96,185,0.0,14,8
..\DataSets\DelayGraph_1131.graphml,131,146,277,0.0009999275207519531,30,10
..\DataSets\DelayGraph_1132.graphml,212,228,440,0.0,37,0
..\DataSets\DelayGraph_1133.graphml,212,228,440,0.0,37,0
..\DataSets\DelayGraph_1134.graphml,1640,2121,3761,0.015599966049194336,305,822
..\DataSets\DelayGraph_1136.graphml,1621,2101,3722,0.0,161,466
..\DataSets\DelayGraph_1138.graphml,208,223,431,0.0,37,12
..\DataSets\DelayGraph_1139.graphml,54,51,105,0.0,9,2
..\DataSets\DelayGraph_1140.graphml,212,210,422,0.0,40,3
..\DataSets\DelayGraph_1141.graphml,101,108,209,0.0,19,7
..\DataSets\DelayGraph_1142.graphml,101,108,209,0.0,19,7
..\DataSets\DelayGraph_1143.graphml,118,123,241,0.0,24,3
..\DataSets\DelayGraph_1144.graphml,118,123,241,0.0,24,3
..\DataSets\DelayGraph_1145.graphml,36,35,71,0.0,6,1
..\DataSets\DelayGraph_1146.graphml,36,35,71,0.0,6,1
..\DataSets\DelayGraph_1147.graphml,8,7,15,0.0,2,0
..\DataSets\DelayGraph_1148.graphml,28,28,56,0.0,8,0
..\DataSets\DelayGraph_1149.graphml,28,28,56,0.0,8,0
..\DataSets\DelayGraph_1150.graphml,233,242,475,0.0,40,6
..\DataSets\DelayGraph_1151.graphml,128,132,260,0.0,11,20
..\DataSets\DelayGraph_1152.graphml,128,132,260,0.0,11,20
..\DataSets\DelayGraph_1154.graphml,145,154,299,0.0,7,5
..\DataSets\DelayGraph_1155.graphml,145,154,299,0.0,7,5
..\DataSets\DelayGraph_1156.graphml,58,58,116,0.0,11,1
..\DataSets\DelayGraph_1157.graphml,152,203,355,0.0,109,1
..\DataSets\DelayGraph_1158.graphml,152,203,355,0.0,109,1
..\DataSets\DelayGraph_1159.graphml,152,203,355,0.0,109,1
..\DataSets\DelayGraph_1160.graphml,51,53,104,0.0,11,2
..\DataSets\DelayGraph_1161.graphml,3,2,5,0.0,1,0
..\DataSets\DelayGraph_1162.graphml,387,419,806,0.0,80,9
..\DataSets\DelayGraph_1163.graphml,730,854,1584,0.0,187,7
..\DataSets\DelayGraph_1164.graphml,730,854,1584,0.0,187,7
..\DataSets\DelayGraph_1165.graphml,90,90,180,0.0,18,3
..\DataSets\DelayGraph_1166.graphml,180,201,381,0.0,54,0
..\DataSets\DelayGraph_1167.graphml,180,201,381,0.0,54,0
..\DataSets\DelayGraph_1177.graphml,117,137,254,0.0,150,5
..\DataSets\DelayGraph_1178.graphml,63,71,134,0.0,11,6
..\DataSets\DelayGraph_1183.graphml,54,57,111,0.0,6,4
..\DataSets\DelayGraph_1184.graphml,943,1007,1950,0.015599966049194336,510,931
..\DataSets\DelayGraph_1185.graphml,943,1007,1950,0.0,510,931
..\DataSets\DelayGraph_1186.graphml,96,94,190,0.0,4,0
..\DataSets\DelayGraph_1187.graphml,96,94,190,0.0,4,0
..\DataSets\DelayGraph_1188.graphml,37,37,74,0.0,4,0
..\DataSets\DelayGraph_1189.graphml,37,37,74,0.0,4,0
..\DataSets\DelayGraph_1190.graphml,158,165,323,0.0,13,7
..\DataSets\DelayGraph_1191.graphml,201,218,419,0.0,50,5
..\DataSets\DelayGraph_1192.graphml,201,218,419,0.0,50,5
..\DataSets\DelayGraph_1193.graphml,201,218,419,0.0,50,5
..\DataSets\DelayGraph_1194.graphml,189,205,394,0.0,16,12
..\DataSets\DelayGraph_1195.graphml,59,62,121,0.0,5,3
..\DataSets\DelayGraph_1196.graphml,113,129,242,0.0,33,0
..\DataSets\DelayGraph_1197.graphml,113,129,242,0.0,33,0
..\DataSets\DelayGraph_1198.graphml,4,3,7,0.0,1,0
..\DataSets\DelayGraph_1199.graphml,848,945,1793,0.0,170,32
..\DataSets\DelayGraph_1200.graphml,1105,1282,2387,0.0,579,104
..\DataSets\DelayGraph_1201.graphml,1246,1442,2688,0.0,305,26
..\DataSets\DelayGraph_1202.graphml,848,945,1793,0.0,170,32
..\DataSets\DelayGraph_1203.graphml,268,268,536,0.0,80,8
..\DataSets\DelayGraph_1204.graphml,1346,1882,3228,0.0,146,40
..\DataSets\DelayGraph_1205.graphml,1346,1882,3228,0.0,146,40
..\DataSets\DelayGraph_1206.graphml,274,301,575,0.0,83,18
..\DataSets\DelayGraph_1207.graphml,152,179,331,0.0,139,0
..\DataSets\DelayGraph_1208.graphml,152,179,331,0.0,139,0
..\DataSets\DelayGraph_1209.graphml,20,21,41,0.0,6,0
..\DataSets\DelayGraph_1210.graphml,20,21,41,0.0,6,0
..\DataSets\DelayGraph_1211.graphml,1746,2245,3991,0.0,424,416
..\DataSets\DelayGraph_1212.graphml,1643,2124,3767,0.0,419,404
..\DataSets\DelayGraph_1213.graphml,1401,1862,3263,0.0,506,74
..\DataSets\DelayGraph_1216.graphml,108,106,214,0.0,14,2
..\DataSets\DelayGraph_1217.graphml,116,135,251,0.0,57,12
..\DataSets\DelayGraph_1223.graphml,63,71,134,0.0,11,6
..\DataSets\DelayGraph_1225.graphml,458,472,930,0.0,87,15
..\DataSets\DelayGraph_1226.graphml,90,89,179,0.0,12,2
..\DataSets\DelayGraph_1227.graphml,135,131,266,0.0,17,4
..\DataSets\DelayGraph_1228.graphml,124,136,260,0.0,18,9
..\DataSets\DelayGraph_1229.graphml,174,207,381,0.0,194,8
..\DataSets\DelayGraph_1230.graphml,226,252,478,0.0,64,0
..\DataSets\DelayGraph_1231.graphml,187,206,393,0.0,52,4
..\DataSets\DelayGraph_1232.graphml,375,448,823,0.0,450,16
..\DataSets\DelayGraph_1233.graphml,79,85,164,0.0,19,2
..\DataSets\DelayGraph_1234.graphml,580,724,1304,0.0,764,24
..\DataSets\DelayGraph_1235.graphml,79,85,164,0.0,19,2
..\DataSets\DelayGraph_1236.graphml,93,95,188,0.0,9,4
..\DataSets\DelayGraph_1237.graphml,93,95,188,0.0,9,4
..\DataSets\DelayGraph_1238.graphml,147,166,313,0.0,39,11
..\DataSets\DelayGraph_1239.graphml,123,135,258,0.0,14,11
..\DataSets\DelayGraph_1240.graphml,90,96,186,0.0,17,2
..\DataSets\DelayGraph_1241.graphml,90,96,186,0.0,17,2
..\DataSets\DelayGraph_1243.graphml,26,25,51,0.0,7,0
..\DataSets\DelayGraph_1244.graphml,3,2,5,0.0,1,0
..\DataSets\DelayGraph_1245.graphml,3,2,5,0.0,1,0
..\DataSets\DelayGraph_1246.graphml,3,2,5,0.0,1,0
..\DataSets\DelayGraph_1247.graphml,65,60,125,0.0,11,0
..\DataSets\DelayGraph_1248.graphml,65,60,125,0.0,11,0
..\DataSets\DelayGraph_1254.graphml,558,697,1255,0.0,313,3
..\DataSets\DelayGraph_1257.graphml,173,177,350,0.0,24,6
..\DataSets\DelayGraph_1264.graphml,117,137,254,0.0,150,5
..\DataSets\DelayGraph_1267.graphml,61,69,130,0.0,11,6
..\DataSets\DelayGraph_1271.graphml,44,44,88,0.0,6,1
..\DataSets\DelayGraph_1272.graphml,115,120,235,0.0,12,0
..\DataSets\DelayGraph_1276.graphml,141,167,308,0.0,163,5
..\DataSets\DelayGraph_1277.graphml,115,120,235,0.0,12,0
..\DataSets\DelayGraph_1278.graphml,64,67,131,0.0,12,2
..\DataSets\DelayGraph_1279.graphml,3586,4212,7798,0.015599966049194336,850,0
..\DataSets\DelayGraph_1280.graphml,3586,4212,7798,0.015599966049194336,850,0
..\DataSets\DelayGraph_1281.graphml,398,435,833,0.0,88,15
..\DataSets\DelayGraph_1282.graphml,444,534,978,0.0,238,114
..\DataSets\DelayGraph_1283.graphml,202,227,429,0.0,61,0
..\DataSets\DelayGraph_1284.graphml,202,227,429,0.0,61,0
..\DataSets\DelayGraph_1285.graphml,372,390,762,0.0,108,16
..\DataSets\DelayGraph_1286.graphml,606,680,1286,0.0,599,8
..\DataSets\DelayGraph_1287.graphml,606,680,1286,0.0,599,8
..\DataSets\DelayGraph_1288.graphml,746,811,1557,0.0,672,931
..\DataSets\DelayGraph_1289.graphml,746,811,1557,0.0,672,931
..\DataSets\DelayGraph_1290.graphml,117,115,232,0.0,4,0
..\DataSets\DelayGraph_1291.graphml,117,115,232,0.0,4,0
..\DataSets\DelayGraph_1292.graphml,94,97,191,0.0,18,2
..\DataSets\DelayGraph_1293.graphml,185,203,388,0.0,57,3
..\DataSets\DelayGraph_1294.graphml,185,203,388,0.0,57,3
..\DataSets\DelayGraph_1295.graphml,185,203,388,0.0,57,3
..\DataSets\DelayGraph_1296.graphml,6,5,11,0.0,1,0
..\DataSets\DelayGraph_1297.graphml,14,13,27,0.0,3,0
..\DataSets\DelayGraph_1298.graphml,14,13,27,0.0,3,0
..\DataSets\DelayGraph_1299.graphml,6,5,11,0.0,1,0
..\DataSets\DelayGraph_1300.graphml,517,539,1056,0.0,117,10
..\DataSets\DelayGraph_1301.graphml,82,88,170,0.0,21,0
..\DataSets\DelayGraph_1302.graphml,82,88,170,0.0,21,0
..\DataSets\DelayGraph_1306.graphml,305,324,629,0.0,66,13
..\DataSets\DelayGraph_1307.graphml,184,224,408,0.0,74,168
..\DataSets\DelayGraph_1308.graphml,184,224,408,0.0,74,168
..\DataSets\DelayGraph_1309.graphml,42,42,84,0.0,6,2
..\DataSets\DelayGraph_1310.graphml,169,198,367,0.0,168,0
..\DataSets\DelayGraph_1311.graphml,169,198,367,0.0,168,0
..\DataSets\DelayGraph_1312.graphml,52,48,100,0.0,8,0
..\DataSets\DelayGraph_1313.graphml,52,48,100,0.0,8,0
..\DataSets\DelayGraph_1314.graphml,150,156,306,0.0,26,5
..\DataSets\DelayGraph_1315.graphml,301,324,625,0.0,60,0
..\DataSets\DelayGraph_1319.graphml,110,128,238,0.0,26,11
..\DataSets\DelayGraph_1320.graphml,153,182,335,0.0,87,13
..\DataSets\DelayGraph_1324.graphml,124,146,270,0.0,51,11
..\DataSets\DelayGraph_1330.graphml,110,128,238,0.0,26,11
..\DataSets\DelayGraph_1332.graphml,301,324,625,0.0,60,0
..\DataSets\DelayGraph_1333.graphml,25,26,51,0.0,5,0
..\DataSets\DelayGraph_1334.graphml,25,26,51,0.0,5,0
..\DataSets\DelayGraph_1335.graphml,92,100,192,0.0,14,9
..\DataSets\DelayGraph_1337.graphml,161,164,325,0.0,22,5
..\DataSets\DelayGraph_1338.graphml,183,173,356,0.0,32,5
..\DataSets\DelayGraph_1339.graphml,183,173,356,0.0,32,5
..\DataSets\DelayGraph_1342.graphml,1263,1496,2759,0.0,416,0
..\DataSets\DelayGraph_1344.graphml,1263,1496,2759,0.0,416,0
..\DataSets\DelayGraph_1345.graphml,138,177,315,0.0,47,217
..\DataSets\DelayGraph_1346.graphml,92,91,183,0.0,23,2
..\DataSets\DelayGraph_1347.graphml,90,104,194,0.0,32,0
..\DataSets\DelayGraph_1348.graphml,37,37,74,0.0,7,1
..\DataSets\DelayGraph_1349.graphml,30,30,60,0.0,7,1
..\DataSets\DelayGraph_1350.graphml,55,66,121,0.0,33,0
..\DataSets\DelayGraph_1351.graphml,53,67,120,0.0,33,0
..\DataSets\DelayGraph_1352.graphml,304,343,647,0.0,55,18
..\DataSets\DelayGraph_1353.graphml,304,343,647,0.0,55,18
..\DataSets\DelayGraph_1354.graphml,243,266,509,0.0,99,6
..\DataSets\DelayGraph_1355.graphml,243,266,509,0.0,99,6
..\DataSets\DelayGraph_1356.graphml,62,65,127,0.0,8,9
..\DataSets\DelayGraph_1357.graphml,486,594,1080,0.0,90,10
..\DataSets\DelayGraph_1358.graphml,486,594,1080,0.0,90,10
..\DataSets\DelayGraph_1359.graphml,12,9,21,0.0,3,0
..\DataSets\DelayGraph_1360.graphml,12,9,21,0.0,3,0
..\DataSets\DelayGraph_1361.graphml,95,96,191,0.0,18,2
..\DataSets\DelayGraph_1362.graphml,95,96,191,0.0,18,2
..\DataSets\DelayGraph_1374.graphml,62,61,123,0.0,10,0
..\DataSets\DelayGraph_1375.graphml,62,61,123,0.0,10,0
..\DataSets\DelayGraph_1376.graphml,127,123,250,0.0,4,0
..\DataSets\DelayGraph_1377.graphml,127,123,250,0.0,4,0
..\DataSets\DelayGraph_1378.graphml,16,15,31,0.0,2,0
..\DataSets\DelayGraph_1379.graphml,16,15,31,0.0,2,0
..\DataSets\DelayGraph_1380.graphml,335,357,692,0.0,189,24
..\DataSets\DelayGraph_1381.graphml,300,333,633,0.015599966049194336,663,32
..\DataSets\DelayGraph_1382.graphml,173,225,398,0.015599966049194336,441,0
..\DataSets\DelayGraph_1383.graphml,173,225,398,0.0,441,0
..\DataSets\DelayGraph_1384.graphml,58,58,116,0.0,11,2
..\DataSets\DelayGraph_1385.graphml,60,61,121,0.0,10,2
..\DataSets\DelayGraph_1388.graphml,104,106,210,0.0,27,2
..\DataSets\DelayGraph_1389.graphml,128,132,260,0.0,33,1
..\DataSets\DelayGraph_1390.graphml,104,106,210,0.0,27,2
..\DataSets\DelayGraph_1391.graphml,79,81,160,0.0,14,2
..\DataSets\DelayGraph_1394.graphml,36,34,70,0.0,10,0
..\DataSets\DelayGraph_1395.graphml,36,34,70,0.0,10,0
..\DataSets\DelayGraph_1396.graphml,237,283,520,0.0,73,16
..\DataSets\DelayGraph_1397.graphml,237,283,520,0.0,73,16
..\DataSets\DelayGraph_1398.graphml,237,283,520,0.0,73,16
..\DataSets\DelayGraph_1399.graphml,495,538,1033,0.0,122,31
..\DataSets\DelayGraph_1400.graphml,495,538,1033,0.0,122,31
..\DataSets\DelayGraph_1401.graphml,63,65,128,0.0,13,2
..\DataSets\DelayGraph_1402.graphml,193,228,421,0.0,70,0
..\DataSets\DelayGraph_1403.graphml,193,228,421,0.0,70,0
..\DataSets\DelayGraph_1404.graphml,84,86,170,0.0,14,0
..\DataSets\DelayGraph_1409.graphml,19,19,38,0.0,4,2
..\DataSets\DelayGraph_1410.graphml,19,19,38,0.0,4,2
..\DataSets\DelayGraph_1411.graphml,224,231,455,0.0,38,6
..\DataSets\DelayGraph_1412.graphml,208,223,431,0.0,37,12
..\DataSets\DelayGraph_1413.graphml,118,123,241,0.0,24,3
..\DataSets\DelayGraph_1414.graphml,16,14,30,0.0,4,0
..\DataSets\DelayGraph_1415.graphml,16,14,30,0.0,4,0
..\DataSets\DelayGraph_1418.graphml,62,65,127,0.0,20,3
..\DataSets\DelayGraph_1419.graphml,62,65,127,0.0,20,3
..\DataSets\DelayGraph_1420.graphml,101,116,217,0.0,112,0
..\DataSets\DelayGraph_1421.graphml,43,33,76,0.0,11,0
..\DataSets\DelayGraph_1422.graphml,43,33,76,0.0,11,0
..\DataSets\DelayGraph_1423.graphml,43,33,76,0.0,11,0
..\DataSets\DelayGraph_1424.graphml,14,14,28,0.0,4,0
..\DataSets\DelayGraph_1425.graphml,26,28,54,0.0,11,0
..\DataSets\DelayGraph_1426.graphml,76,80,156,0.0,21,0
..\DataSets\DelayGraph_1427.graphml,76,80,156,0.0,21,0
..\DataSets\DelayGraph_1428.graphml,138,149,287,0.0,31,11
..\DataSets\DelayGraph_1429.graphml,138,149,287,0.0,31,11
..\DataSets\DelayGraph_1430.graphml,138,149,287,0.0,31,11
..\DataSets\DelayGraph_1431.graphml,193,204,397,0.0,5,9
..\DataSets\DelayGraph_1432.graphml,238,250,488,0.0,4,8
..\DataSets\DelayGraph_1433.graphml,330,360,690,0.015599966049194336,23,4
..\DataSets\DelayGraph_1434.graphml,392,416,808,0.0,25,11
..\DataSets\DelayGraph_1435.graphml,347,370,717,0.0,26,12
..\DataSets\DelayGraph_1436.graphml,285,314,599,0.0,24,5
..\DataSets\DelayGraph_1438.graphml,116,135,251,0.0,57,12
..\DataSets\DelayGraph_1439.graphml,116,135,251,0.0,57,12
..\DataSets\DelayGraph_1441.graphml,63,71,134,0.0,11,6
..\DataSets\DelayGraph_1446.graphml,238,250,488,0.0,4,8
..\DataSets\DelayGraph_1447.graphml,685,738,1423,0.0,202,11
..\DataSets\DelayGraph_1448.graphml,4272,4978,9250,0.015599966049194336,219,72
..\DataSets\DelayGraph_1449.graphml,3469,4210,7679,0.0,8,64
..\DataSets\DelayGraph_1450.graphml,3469,4210,7679,0.0,8,64
..\DataSets\DelayGraph_1451.graphml,357,385,742,0.0,76,12
..\DataSets\DelayGraph_1452.graphml,18,17,35,0.0,2,0
..\DataSets\DelayGraph_1453.graphml,18,17,35,0.0,2,0
..\DataSets\DelayGraph_1454.graphml,36,31,67,0.0,8,0
..\DataSets\DelayGraph_1455.graphml,36,31,67,0.0,8,0
..\DataSets\DelayGraph_1456.graphml,20,19,39,0.0,2,0
..\DataSets\DelayGraph_1457.graphml,20,19,39,0.0,2,0
..\DataSets\DelayGraph_1458.graphml,112,121,233,0.0,30,14
..\DataSets\DelayGraph_1461.graphml,60,50,110,0.0,10,0
..\DataSets\DelayGraph_1462.graphml,60,50,110,0.0,10,0
..\DataSets\DelayGraph_1463.graphml,44,44,88,0.0,7,2
..\DataSets\DelayGraph_1464.graphml,23,21,44,0.0,3,0
..\DataSets\DelayGraph_1465.graphml,110,126,236,0.0,33,0
..\DataSets\DelayGraph_1466.graphml,110,126,236,0.0,33,0
..\DataSets\DelayGraph_1467.graphml,88,94,182,0.0,24,1
..\DataSets\DelayGraph_1468.graphml,237,257,494,0.0,54,8
..\DataSets\DelayGraph_1469.graphml,235,300,535,0.0,150,0
..\DataSets\DelayGraph_1470.graphml,235,300,535,0.0,150,0
..\DataSets\DelayGraph_1471.graphml,237,257,494,0.015600204467773438,54,8
..\DataSets\DelayGraph_1472.graphml,235,300,535,0.0,150,0
..\DataSets\DelayGraph_1473.graphml,235,300,535,0.0,150,0
..\DataSets\DelayGraph_1474.graphml,222,235,457,0.0010001659393310547,54,8
..\DataSets\DelayGraph_1475.graphml,215,280,495,0.0,150,0
..\DataSets\DelayGraph_1476.graphml,215,280,495,0.0,150,0
..\DataSets\DelayGraph_1483.graphml,11,9,20,0.0,2,0
..\DataSets\DelayGraph_1484.graphml,13,11,24,0.0,3,0
..\DataSets\DelayGraph_1490.graphml,8,7,15,0.0,2,0
..\DataSets\DelayGraph_1491.graphml,16,15,31,0.0,4,0
..\DataSets\DelayGraph_1492.graphml,3821,4147,7968,0.015599966049194336,298,61
..\DataSets\DelayGraph_1494.graphml,1403,1864,3267,0.0,506,74
..\DataSets\DelayGraph_1497.graphml,160,159,319,0.0,4,0
..\DataSets\DelayGraph_1498.graphml,61,69,130,0.0,11,6
..\DataSets\DelayGraph_1503.graphml,160,159,319,0.0,4,0
..\DataSets\DelayGraph_1504.graphml,60,56,116,0.0,9,0
..\DataSets\DelayGraph_1505.graphml,706,796,1502,0.0,285,164
..\DataSets\DelayGraph_1508.graphml,51,58,109,0.0,3,3
..\DataSets\DelayGraph_1509.graphml,51,58,109,0.0,3,3
..\DataSets\DelayGraph_1511.graphml,53,57,110,0.0,13,1
..\DataSets\DelayGraph_1512.graphml,53,57,110,0.0,13,1
..\DataSets\DelayGraph_1513.graphml,46,44,90,0.0,6,2
..\DataSets\DelayGraph_1514.graphml,84,88,172,0.0,24,0
..\DataSets\DelayGraph_1515.graphml,13,13,26,0.0,4,0
..\DataSets\DelayGraph_1516.graphml,44,45,89,0.0,15,0
..\DataSets\DelayGraph_1517.graphml,34,31,65,0.0,5,0
..\DataSets\DelayGraph_1518.graphml,34,31,65,0.0,5,0
..\DataSets\DelayGraph_1519.graphml,111,119,230,0.0,22,6
..\DataSets\DelayGraph_1520.graphml,111,119,230,0.0,22,6
..\DataSets\DelayGraph_1521.graphml,90,95,185,0.0,13,4
..\DataSets\DelayGraph_1522.graphml,90,95,185,0.0,13,4
..\DataSets\DelayGraph_1523.graphml,90,95,185,0.0,13,4
..\DataSets\DelayGraph_1524.graphml,47,55,102,0.0,22,0
..\DataSets\DelayGraph_1525.graphml,47,55,102,0.0,22,0
..\DataSets\DelayGraph_1526.graphml,132,135,267,0.0,15,9
..\DataSets\DelayGraph_1527.graphml,198,222,420,0.0,60,0
..\DataSets\DelayGraph_1528.graphml,198,222,420,0.0,60,0
..\DataSets\DelayGraph_1532.graphml,1599,2075,3674,0.015599966049194336,161,106
..\DataSets\DelayGraph_1535.graphml,1873,2422,4295,0.0,693,806
..\DataSets\DelayGraph_1536.graphml,1873,2422,4295,0.015599966049194336,693,806
..\DataSets\DelayGraph_1537.graphml,36,37,73,0.0,7,1
..\DataSets\DelayGraph_1538.graphml,233,249,482,0.0,35,14
..\DataSets\DelayGraph_1539.graphml,130,153,283,0.0,58,0
..\DataSets\DelayGraph_1540.graphml,130,153,283,0.0,58,0
..\DataSets\DelayGraph_1541.graphml,89,94,183,0.0,34,0
..\DataSets\DelayGraph_1542.graphml,943,1007,1950,0.0,510,931
..\DataSets\DelayGraph_1543.graphml,943,1007,1950,0.0009999275207519531,510,931
..\DataSets\DelayGraph_1544.graphml,43,42,85,0.0,7,1
..\DataSets\DelayGraph_1545.graphml,52,50,102,0.0,7,1
..\DataSets\DelayGraph_1546.graphml,107,113,220,0.0,20,0
..\DataSets\DelayGraph_1547.graphml,107,113,220,0.0,20,0
..\DataSets\DelayGraph_1548.graphml,107,113,220,0.0,20,0
..\DataSets\DelayGraph_1553.graphml,170,201,371,0.0,532,10
..\DataSets\DelayGraph_1555.graphml,118,138,256,0.0,150,5
..\DataSets\DelayGraph_1557.graphml,113,133,246,0.0,57,12
..\DataSets\DelayGraph_1562.graphml,61,69,130,0.0,11,6
..\DataSets\DelayGraph_1564.graphml,71,68,139,0.0,12,0
..\DataSets\DelayGraph_1565.graphml,71,68,139,0.0,12,0
..\DataSets\DelayGraph_1566.graphml,71,68,139,0.0,12,0
..\DataSets\DelayGraph_1567.graphml,49,50,99,0.0,11,1
..\DataSets\DelayGraph_1568.graphml,48,50,98,0.0,12,0
..\DataSets\DelayGraph_1569.graphml,48,50,98,0.0,12,0
..\DataSets\DelayGraph_1570.graphml,205,213,418,0.0,48,11
..\DataSets\DelayGraph_1571.graphml,204,222,426,0.0,58,0
..\DataSets\DelayGraph_1572.graphml,204,222,426,0.0,58,0
..\DataSets\DelayGraph_1573.graphml,344,344,688,0.0,63,7
..\DataSets\DelayGraph_1574.graphml,344,344,688,0.0,63,7
..\DataSets\DelayGraph_1575.graphml,639,718,1357,0.0,173,17
..\DataSets\DelayGraph_1576.graphml,1328,1617,2945,0.0,600,0
..\DataSets\DelayGraph_1577.graphml,1328,1617,2945,0.015600204467773438,600,0
..\DataSets\DelayGraph_1578.graphml,299,338,637,0.0,63,0
..\DataSets\DelayGraph_1579.graphml,299,338,637,0.0,63,0
..\DataSets\DelayGraph_1580.graphml,299,338,637,0.0,63,0
..\DataSets\DelayGraph_1581.graphml,518,556,1074,0.0,152,20
..\DataSets\DelayGraph_1582.graphml,500,642,1142,0.0,404,0
..\DataSets\DelayGraph_1583.graphml,500,642,1142,0.0010001659393310547,404,0
..\DataSets\DelayGraph_1584.graphml,420,470,890,0.0,404,14
..\DataSets\DelayGraph_1596.graphml,3469,4210,7679,0.015599966049194336,8,64
..\DataSets\DelayGraph_1597.graphml,6,3,9,0.0,2,0
..\DataSets\DelayGraph_1598.graphml,6,3,9,0.0,2,0
..\DataSets\DelayGraph_1600.graphml,116,135,251,0.0,57,12
..\DataSets\DelayGraph_1604.graphml,63,71,134,0.0,11,6
..\DataSets\DelayGraph_1607.graphml,492,505,997,0.0,94,15
..\DataSets\DelayGraph_1608.graphml,34,31,65,0.0,5,0
..\DataSets\DelayGraph_1609.graphml,34,31,65,0.0,5,0
..\DataSets\DelayGraph_1610.graphml,477,495,972,0.0,92,3
..\DataSets\DelayGraph_1611.graphml,477,495,972,0.0,92,3
..\DataSets\DelayGraph_1615.graphml,118,119,237,0.0,15,3
..\DataSets\DelayGraph_1616.graphml,1684,1905,3589,0.0,284,0
..\DataSets\DelayGraph_1617.graphml,1684,1905,3589,0.0,284,0
..\DataSets\DelayGraph_1618.graphml,35,34,69,0.0,8,0
..\DataSets\DelayGraph_1619.graphml,11,10,21,0.0,1,0
..\DataSets\DelayGraph_1620.graphml,11,10,21,0.0,1,0
..\DataSets\DelayGraph_1621.graphml,746,811,1557,0.0,672,931
..\DataSets\DelayGraph_1622.graphml,746,811,1557,0.0,672,931
..\DataSets\DelayGraph_1623.graphml,192,208,400,0.0,34,12
..\DataSets\DelayGraph_1624.graphml,90,96,186,0.0,24,0
..\DataSets\DelayGraph_1625.graphml,90,96,186,0.0,24,0
..\DataSets\DelayGraph_1626.graphml,290,308,598,0.0,65,14
..\DataSets\DelayGraph_1627.graphml,2384,3224,5608,0.0,726,300
..\DataSets\DelayGraph_1628.graphml,2384,3224,5608,0.0,726,300
..\DataSets\DelayGraph_1629.graphml,221,237,458,0.0,83,9
..\DataSets\DelayGraph_1630.graphml,368,397,765,0.0,135,0
..\DataSets\DelayGraph_1633.graphml,126,147,273,0.0,274,5
..\DataSets\DelayGraph_1635.graphml,368,397,765,0.0,135,0
..\DataSets\DelayGraph_1636.graphml,49,52,101,0.0,10,2
..\DataSets\DelayGraph_1637.graphml,54,61,115,0.0,36,0
..\DataSets\DelayGraph_1638.graphml,54,61,115,0.0,36,0
..\DataSets\DelayGraph_1640.graphml,123,124,247,0.0,92,2
..\DataSets\DelayGraph_1641.graphml,123,124,247,0.0,92,2
..\DataSets\DelayGraph_1642.graphml,706,796,1502,0.0,285,164
..\DataSets\DelayGraph_1645.graphml,21,22,43,0.0,4,0
..\DataSets\DelayGraph_1646.graphml,27,28,55,0.0,5,0
..\DataSets\DelayGraph_1647.graphml,48,47,95,0.0,8,2
..\DataSets\DelayGraph_1648.graphml,48,47,95,0.0,8,2
..\DataSets\DelayGraph_1649.graphml,24,26,50,0.0,4,1
..\DataSets\DelayGraph_1650.graphml,50,50,100,0.0,8,2
..\DataSets\DelayGraph_1651.graphml,347,399,746,0.0,111,1
..\DataSets\DelayGraph_1652.graphml,347,399,746,0.0,111,1
..\DataSets\DelayGraph_1653.graphml,347,399,746,0.0,111,1
..\DataSets\DelayGraph_1654.graphml,813,1138,1951,0.0,77,9
..\DataSets\DelayGraph_1655.graphml,813,1138,1951,0.0,77,9
..\DataSets\DelayGraph_1661.graphml,13,13,26,0.0,4,0
..\DataSets\DelayGraph_1662.graphml,38,38,76,0.0,7,0
..\DataSets\DelayGraph_1663.graphml,43,45,88,0.0,15,0
..\DataSets\DelayGraph_1664.graphml,69,70,139,0.0,9,9
..\DataSets\DelayGraph_1665.graphml,155,183,338,0.0,44,80
..\DataSets\DelayGraph_1666.graphml,155,183,338,0.0,44,80
..\DataSets\DelayGraph_1667.graphml,27,22,49,0.0,4,0
..\DataSets\DelayGraph_1668.graphml,27,22,49,0.0,4,0
..\DataSets\DelayGraph_1669.graphml,27,22,49,0.0,4,0
..\DataSets\DelayGraph_1678.graphml,74,74,148,0.0,5,1
..\DataSets\DelayGraph_1679.graphml,230,232,462,0.0,8,0
..\DataSets\DelayGraph_1682.graphml,63,71,134,0.0,11,6
..\DataSets\DelayGraph_1684.graphml,230,232,462,0.0,8,0
..\DataSets\DelayGraph_1685.graphml,611,629,1240,0.0,108,16
..\DataSets\DelayGraph_1686.graphml,845,919,1764,0.0,599,8
..\DataSets\DelayGraph_1687.graphml,845,919,1764,0.0,599,8
..\DataSets\DelayGraph_1688.graphml,6,5,11,0.0,1,0
..\DataSets\DelayGraph_1689.graphml,6,5,11,0.0,1,0
..\DataSets\DelayGraph_1690.graphml,16,15,31,0.0,2,0
..\DataSets\DelayGraph_1691.graphml,16,15,31,0.0,2,0
..\DataSets\DelayGraph_1692.graphml,91,93,184,0.0,14,2
..\DataSets\DelayGraph_1693.graphml,7,7,14,0.0,2,0
..\DataSets\DelayGraph_1694.graphml,109,112,221,0.0,16,2
..\DataSets\DelayGraph_1695.graphml,393,495,888,0.0,255,0
..\DataSets\DelayGraph_1696.graphml,393,495,888,0.0,255,0
..\DataSets\DelayGraph_1697.graphml,6,5,11,0.0,1,0
..\DataSets\DelayGraph_1698.graphml,66,69,135,0.0,16,0
..\DataSets\DelayGraph_1699.graphml,66,69,135,0.0,16,0
..\DataSets\DelayGraph_1700.graphml,66,69,135,0.0,16,0
..\DataSets\DelayGraph_1701.graphml,78,82,160,0.0,14,4
..\DataSets\DelayGraph_1704.graphml,98,93,191,0.0,17,0
..\DataSets\DelayGraph_1707.graphml,57,58,115,0.0,15,2
..\DataSets\DelayGraph_1708.graphml,110,119,229,0.0,42,0
..\DataSets\DelayGraph_1709.graphml,110,119,229,0.0,42,0
..\DataSets\DelayGraph_1710.graphml,382,410,792,0.0,86,14
..\DataSets\DelayGraph_1711.graphml,348,442,790,0.0,220,0
..\DataSets\DelayGraph_1712.graphml,348,442,790,0.0,220,0
..\DataSets\DelayGraph_1713.graphml,200,216,416,0.0,46,9
..\DataSets\DelayGraph_1714.graphml,346,394,740,0.015600204467773438,120,0
..\DataSets\DelayGraph_1715.graphml,346,394,740,0.0,120,0
..\DataSets\DelayGraph_1716.graphml,857,1020,1877,0.0,430,92
..\DataSets\DelayGraph_1717.graphml,218,236,454,0.0,62,0
..\DataSets\DelayGraph_1718.graphml,218,236,454,0.0,62,0
..\DataSets\DelayGraph_1719.graphml,202,213,415,0.0,49,6
..\DataSets\DelayGraph_1721.graphml,126,147,273,0.0,274,5
..\DataSets\DelayGraph_1726.graphml,80,82,162,0.0,17,0
..\DataSets\DelayGraph_1727.graphml,80,82,162,0.0,17,0
..\DataSets\DelayGraph_1728.graphml,80,82,162,0.0,17,0
..\DataSets\DelayGraph_1729.graphml,23,23,46,0.0,5,0
..\DataSets\DelayGraph_1730.graphml,20,19,39,0.0,5,1
..\DataSets\DelayGraph_1731.graphml,20,19,39,0.0,5,1
..\DataSets\DelayGraph_1732.graphml,54,51,105,0.0,9,2
..\DataSets\DelayGraph_1733.graphml,137,133,270,0.0,17,3
..\DataSets\DelayGraph_1734.graphml,134,142,276,0.0,34,2
..\DataSets\DelayGraph_1735.graphml,16,14,30,0.0,4,0
..\DataSets\DelayGraph_1736.graphml,16,14,30,0.0,4,0
..\DataSets\DelayGraph_1737.graphml,188,199,387,0.0,14,8
..\DataSets\DelayGraph_1738.graphml,84,80,164,0.0,17,2
..\DataSets\DelayGraph_1739.graphml,84,80,164,0.0,17,2
..\DataSets\DelayGraph_1740.graphml,45,46,91,0.0,9,2
..\DataSets\DelayGraph_1741.graphml,169,195,364,0.0,184,6
..\DataSets\DelayGraph_1742.graphml,278,312,590,0.015600204467773438,96,0
..\DataSets\DelayGraph_1743.graphml,212,235,447,0.0,76,4
..\DataSets\DelayGraph_1744.graphml,365,424,789,0.0,446,12
..\DataSets\DelayGraph_1745.graphml,93,101,194,0.0,27,2
..\DataSets\DelayGraph_1746.graphml,560,676,1236,0.0,724,16
..\DataSets\DelayGraph_1747.graphml,212,235,447,0.0,76,4
..\DataSets\DelayGraph_1748.graphml,3821,4147,7968,0.0,298,61
..\DataSets\DelayGraph_1749.graphml,65,66,131,0.0,12,1
..\DataSets\DelayGraph_1750.graphml,65,66,131,0.0,12,1
..\DataSets\DelayGraph_1751.graphml,88,94,182,0.0,24,1
..\DataSets\DelayGraph_1753.graphml,37,38,75,0.0,13,0
..\DataSets\DelayGraph_1754.graphml,42,53,95,0.0,29,0
..\DataSets\DelayGraph_1755.graphml,42,53,95,0.0,29,0
..\DataSets\DelayGraph_1756.graphml,567,648,1215,0.0,123,72
..\DataSets\DelayGraph_1759.graphml,146,158,304,0.0,36,11
..\DataSets\DelayGraph_1760.graphml,146,158,304,0.0,36,11
..\DataSets\DelayGraph_1761.graphml,146,158,304,0.0,36,11
..\DataSets\DelayGraph_1762.graphml,69,76,145,0.0,20,0
..\DataSets\DelayGraph_1763.graphml,69,76,145,0.0,20,0
..\DataSets\DelayGraph_1768.graphml,192,201,393,0.0,40,6
..\DataSets\DelayGraph_1769.graphml,192,201,393,0.0,40,6
..\DataSets\DelayGraph_1770.graphml,76,80,156,0.0,9,5
..\DataSets\DelayGraph_1771.graphml,141,167,308,0.0,163,5
..\DataSets\DelayGraph_1773.graphml,141,167,308,0.0,163,5
..\DataSets\DelayGraph_1774.graphml,76,80,156,0.0,9,5
..\DataSets\DelayGraph_1775.graphml,61,60,121,0.0,12,2
..\DataSets\DelayGraph_1776.graphml,173,186,359,0.0,30,9
..\DataSets\DelayGraph_1777.graphml,139,149,288,0.0,16,0
..\DataSets\DelayGraph_1778.graphml,126,147,273,0.0,274,5
..\DataSets\DelayGraph_1779.graphml,126,147,273,0.0,274,5
..\DataSets\DelayGraph_1781.graphml,139,149,288,0.0,16,0
..\DataSets\DelayGraph_1782.graphml,17,15,32,0.0,3,1
..\DataSets\DelayGraph_1783.graphml,648,651,1299,0.0010001659393310547,13,5
..\DataSets\DelayGraph_1784.graphml,7630,7674,15304,0.031199932098388672,137,0
..\DataSets\DelayGraph_1785.graphml,7630,7674,15304,0.04680013656616211,137,0
..\DataSets\DelayGraph_1786.graphml,921,985,1906,0.0,510,931
..\DataSets\DelayGraph_1787.graphml,921,985,1906,0.0019998550415039062,510,931
..\DataSets\DelayGraph_1788.graphml,501,550,1051,0.0,42,132
..\DataSets\DelayGraph_1789.graphml,98,101,199,0.0,8,3
..\DataSets\DelayGraph_1790.graphml,136,155,291,0.0,207,0
..\DataSets\DelayGraph_1793.graphml,136,157,293,0.0,150,5
..\DataSets\DelayGraph_1795.graphml,136,155,291,0.0,207,0
..\DataSets\DelayGraph_1796.graphml,109,108,217,0.0,8,2
..\DataSets\DelayGraph_1799.graphml,136,157,293,0.0,150,5
..\DataSets\DelayGraph_1801.graphml,109,108,217,0.0,8,2
..\DataSets\DelayGraph_1802.graphml,539,573,1112,0.0,197,21
..\DataSets\DelayGraph_1803.graphml,719,801,1520,0.0,360,0
..\DataSets\DelayGraph_1804.graphml,719,801,1520,0.0,360,0
..\DataSets\DelayGraph_1805.graphml,35,33,68,0.0,5,0
..\DataSets\DelayGraph_1806.graphml,531,561,1092,0.0009999275207519531,59,0
..\DataSets\DelayGraph_1807.graphml,42,45,87,0.0,10,0
..\DataSets\DelayGraph_1808.graphml,42,45,87,0.0,10,0
..\DataSets\DelayGraph_1809.graphml,15,15,30,0.0,4,0
..\DataSets\DelayGraph_1810.graphml,89,96,185,0.0,14,8
..\DataSets\DelayGraph_1811.graphml,249,284,533,0.0,132,28
..\DataSets\DelayGraph_1812.graphml,386,420,806,0.0,78,0
..\DataSets\DelayGraph_1813.graphml,386,420,806,0.0,78,0
..\DataSets\DelayGraph_1814.graphml,89,96,185,0.0,14,8
..\DataSets\DelayGraph_1815.graphml,131,146,277,0.0,30,10
..\DataSets\DelayGraph_1816.graphml,212,228,440,0.0,37,0
..\DataSets\DelayGraph_1817.graphml,212,228,440,0.0,37,0
..\DataSets\DelayGraph_1818.graphml,1873,2422,4295,0.0,693,806
..\DataSets\DelayGraph_1824.graphml,116,135,251,0.0,57,12
..\DataSets\DelayGraph_1826.graphml,63,71,134,0.0,11,6
..\DataSets\DelayGraph_1827.graphml,458,472,930,0.0,87,15
..\DataSets\DelayGraph_1828.graphml,68,68,136,0.0,10,0
..\DataSets\DelayGraph_1829.graphml,378,407,785,0.0,96,21
..\DataSets\DelayGraph_1830.graphml,134,142,276,0.0,34,2
..\DataSets\DelayGraph_1831.graphml,134,142,276,0.0,34,2
..\DataSets\DelayGraph_1832.graphml,9,8,17,0.0,2,0
..\DataSets\DelayGraph_1833.graphml,353,481,834,0.0,245,0
..\DataSets\DelayGraph_1834.graphml,147,166,313,0.0,39,11
..\DataSets\DelayGraph_1835.graphml,228,245,473,0.0,75,9
..\DataSets\DelayGraph_1836.graphml,191,205,396,0.0,89,5
..\DataSets\DelayGraph_1837.graphml,86,96,182,0.0,28,0
..\DataSets\DelayGraph_1838.graphml,86,96,182,0.0,28,0
..\DataSets\DelayGraph_1839.graphml,46,44,90,0.0,6,2
..\DataSets\DelayGraph_1840.graphml,383,426,809,0.0,285,19
..\DataSets\DelayGraph_1843.graphml,59,61,120,0.0,11,1
..\DataSets\DelayGraph_1845.graphml,27,26,53,0.0,6,1
..\DataSets\DelayGraph_1846.graphml,42,53,95,0.0,29,0
..\DataSets\DelayGraph_1847.graphml,42,53,95,0.0,29,0
..\DataSets\DelayGraph_1848.graphml,69,70,139,0.0,13,4
..\DataSets\DelayGraph_1849.graphml,69,70,139,0.0,13,4
..\DataSets\DelayGraph_1850.graphml,69,70,139,0.0,13,4
..\DataSets\DelayGraph_1851.graphml,581,721,1302,0.0,325,7
..\DataSets\DelayGraph_1852.graphml,581,721,1302,0.0,325,7
..\DataSets\DelayGraph_1853.graphml,79,87,166,0.0,159,18
..\DataSets\DelayGraph_1866.graphml,102,113,215,0.0,226,24
..\DataSets\DelayGraph_1874.graphml,35,34,69,0.0,4,2
..\DataSets\DelayGraph_1875.graphml,97,103,200,0.0,31,0
..\DataSets\DelayGraph_1878.graphml,138,159,297,0.0,150,5
..\DataSets\DelayGraph_1881.graphml,193,224,417,0.0,532,10
..\DataSets\DelayGraph_1882.graphml,113,133,246,0.0,57,12
..\DataSets\DelayGraph_1885.graphml,61,69,130,0.0,11,6
..\DataSets\DelayGraph_1888.graphml,97,103,200,0.0,31,0
..\DataSets\DelayGraph_1889.graphml,2196,2409,4605,0.015599966049194336,798,52
..\DataSets\DelayGraph_1897.graphml,63,63,126,0.0,9,2
..\DataSets\DelayGraph_1898.graphml,1063,1322,2385,0.0,366,4
..\DataSets\DelayGraph_1901.graphml,1599,2075,3674,0.002000093460083008,161,106
..\DataSets\DelayGraph_1904.graphml,1873,2422,4295,0.015599966049194336,693,806
..\DataSets\DelayGraph_1905.graphml,1873,2422,4295,0.0,693,806
..\DataSets\DelayGraph_1906.graphml,139,149,288,0.0,16,0
..\DataSets\DelayGraph_1907.graphml,126,147,273,0.0,274,5
..\DataSets\DelayGraph_1908.graphml,126,147,273,0.0,274,5
..\DataSets\DelayGraph_1910.graphml,139,149,288,0.0,16,0
..\DataSets\DelayGraph_1911.graphml,60,50,110,0.0,10,0
..\DataSets\DelayGraph_1912.graphml,60,50,110,0.0,10,0
..\DataSets\DelayGraph_1913.graphml,84,94,178,0.0,11,12
..\DataSets\DelayGraph_1914.graphml,113,129,242,0.0,33,0
..\DataSets\DelayGraph_1915.graphml,113,129,242,0.0,33,0
..\DataSets\DelayGraph_1916.graphml,18,18,36,0.0,2,0
..\DataSets\DelayGraph_1919.graphml,176,206,382,0.0,167,13
..\DataSets\DelayGraph_1921.graphml,18,18,36,0.0,2,0
..\DataSets\DelayGraph_1922.graphml,6,5,11,0.0,1,0
..\DataSets\DelayGraph_1923.graphml,335,331,666,0.0,60,4
..\DataSets\DelayGraph_1924.graphml,335,331,666,0.0,60,4
..\DataSets\DelayGraph_1928.graphml,51,47,98,0.0,6,1
..\DataSets\DelayGraph_1929.graphml,51,47,98,0.0,6,1
..\DataSets\DelayGraph_1934.graphml,550,580,1130,0.0,59,0
..\DataSets\DelayGraph_1935.graphml,70,75,145,0.0,11,5
..\DataSets\DelayGraph_1936.graphml,123,130,253,0.0,18,0
..\DataSets\DelayGraph_1937.graphml,123,130,253,0.0,18,0
..\DataSets\DelayGraph_1938.graphml,89,96,185,0.0,14,8
..\DataSets\DelayGraph_1940.graphml,731,801,1532,0.0,172,0
..\DataSets\DelayGraph_1941.graphml,731,801,1532,0.0,172,0
..\DataSets\DelayGraph_1942.graphml,1594,2067,3661,0.0,153,88
..\DataSets\DelayGraph_1943.graphml,6915,8776,15691,0.015599966049194336,516,397
..\DataSets\DelayGraph_1944.graphml,6915,8776,15691,0.015599966049194336,516,397
..\DataSets\DelayGraph_1945.graphml,135,131,266,0.0,17,4
..\DataSets\DelayGraph_1946.graphml,493,542,1035,0.0,42,132
..\DataSets\DelayGraph_1949.graphml,3469,4210,7679,0.0,8,64
..\DataSets\DelayGraph_1951.graphml,320,334,654,0.0,28,0
..\DataSets\DelayGraph_1952.graphml,320,334,654,0.0,28,0
..\DataSets\DelayGraph_1953.graphml,320,334,654,0.0,28,0
..\DataSets\DelayGraph_1954.graphml,127,131,258,0.0,11,20
..\DataSets\DelayGraph_1955.graphml,127,131,258,0.0,11,20
..\DataSets\DelayGraph_1956.graphml,115,126,241,0.0,103,3
..\DataSets\DelayGraph_1960.graphml,195,222,417,0.0,40,0
..\DataSets\DelayGraph_1961.graphml,195,222,417,0.0,40,0
..\DataSets\DelayGraph_1962.graphml,20,19,39,0.0,5,1
..\DataSets\DelayGraph_1964.graphml,30,29,59,0.0,7,0
..\DataSets\DelayGraph_1965.graphml,56,60,116,0.0,22,1
..\DataSets\DelayGraph_1966.graphml,47,50,97,0.0,17,0
..\DataSets\DelayGraph_1967.graphml,22,24,46,0.0,8,0
..\DataSets\DelayGraph_1968.graphml,22,24,46,0.0,8,0
..\DataSets\DelayGraph_1969.graphml,74,94,168,0.0,62,0
..\DataSets\DelayGraph_1970.graphml,74,94,168,0.0,62,0
..\DataSets\DelayGraph_1972.graphml,249,277,526,0.0,82,18
..\DataSets\DelayGraph_1975.graphml,47,48,95,0.0,11,0
..\DataSets\DelayGraph_1976.graphml,47,48,95,0.0,11,0
..\DataSets\DelayGraph_1977.graphml,47,48,95,0.0,11,0
..\DataSets\DelayGraph_1978.graphml,43,44,87,0.0,6,1
..\DataSets\DelayGraph_1979.graphml,358,402,760,0.0,63,0
..\DataSets\DelayGraph_1980.graphml,358,402,760,0.0,63,0
..\DataSets\DelayGraph_1981.graphml,159,169,328,0.0,26,8
..\DataSets\DelayGraph_1982.graphml,71,76,147,0.0,34,0
..\DataSets\DelayGraph_1983.graphml,133,143,276,0.0,16,0
..\DataSets\DelayGraph_1985.graphml,126,147,273,0.0,274,5
..\DataSets\DelayGraph_1986.graphml,126,147,273,0.0,274,5
..\DataSets\DelayGraph_1987.graphml,133,143,276,0.0,16,0
..\DataSets\DelayGraph_1990.graphml,36,36,72,0.0,2,0
..\DataSets\DelayGraph_1991.graphml,36,36,72,0.0,2,0
..\DataSets\DelayGraph_1992.graphml,112,121,233,0.0,30,14
..\DataSets\DelayGraph_1995.graphml,76,84,160,0.0,52,0
..\DataSets\DelayGraph_1996.graphml,76,84,160,0.0,52,0
..\DataSets\DelayGraph_1997.graphml,189,200,389,0.015599966049194336,14,8
..\DataSets\DelayGraph_1998.graphml,131,132,263,0.0,31,0
..\DataSets\DelayGraph_1999.graphml,131,132,263,0.0,31,0
..\DataSets\DelayGraph_2000.graphml,181,212,393,0.0,169,13
..\DataSets\DelayGraph_2007.graphml,135,159,294,0.0,53,11
..\DataSets\DelayGraph_2010.graphml,134,157,291,0.0,53,11
..\DataSets\DelayGraph_2014.graphml,180,210,390,0.0,169,13
..\DataSets\DelayGraph_2016.graphml,131,132,263,0.015599966049194336,31,0
..\DataSets\DelayGraph_2017.graphml,41,36,77,0.0,7,0
..\DataSets\DelayGraph_2018.graphml,41,36,77,0.0,7,0
..\DataSets\DelayGraph_2019.graphml,41,36,77,0.0,7,0
..\DataSets\DelayGraph_2020.graphml,16,12,28,0.0,4,0
..\DataSets\DelayGraph_2021.graphml,16,12,28,0.0,4,0
..\DataSets\DelayGraph_2022.graphml,350,398,748,0.0,120,16
..\DataSets\DelayGraph_2025.graphml,6,4,10,0.0,2,0
..\DataSets\DelayGraph_2026.graphml,6,4,10,0.0,2,0
..\DataSets\DelayGraph_2027.graphml,6,4,10,0.0,2,0
..\DataSets\DelayGraph_2028.graphml,6,4,10,0.0,2,0
..\DataSets\DelayGraph_2029.graphml,12,11,23,0.0,3,0
..\DataSets\DelayGraph_2030.graphml,12,11,23,0.0,3,0
..\DataSets\DelayGraph_2031.graphml,649,744,1393,0.0,266,53
..\DataSets\DelayGraph_2032.graphml,649,744,1393,0.0,266,53
..\DataSets\DelayGraph_2034.graphml,133,140,273,0.0,27,16
..\DataSets\DelayGraph_2035.graphml,46,50,96,0.0,11,5
..\DataSets\DelayGraph_2036.graphml,46,50,96,0.0,11,5
..\DataSets\DelayGraph_2042.graphml,63,71,134,0.0,11,6
..\DataSets\DelayGraph_2043.graphml,116,135,251,0.0,57,12
..\DataSets\DelayGraph_2045.graphml,475,488,963,0.0,93,15
..\DataSets\DelayGraph_2046.graphml,81,95,176,0.0,16,0
..\DataSets\DelayGraph_2048.graphml,173,199,372,0.0,184,6
..\DataSets\DelayGraph_2049.graphml,278,312,590,0.0,96,0
..\DataSets\DelayGraph_2050.graphml,216,239,455,0.0,76,4
..\DataSets\DelayGraph_2051.graphml,373,432,805,0.0,446,12
..\DataSets\DelayGraph_2052.graphml,95,103,198,0.0,27,2
..\DataSets\DelayGraph_2053.graphml,568,684,1252,0.0,724,16
..\DataSets\DelayGraph_2054.graphml,568,684,1252,0.0,724,16
..\DataSets\DelayGraph_2055.graphml,67,72,139,0.0,34,0
..\DataSets\DelayGraph_2056.graphml,34,33,67,0.0,6,0
..\DataSets\DelayGraph_2057.graphml,34,33,67,0.0,6,0
..\DataSets\DelayGraph_2058.graphml,34,33,67,0.0,6,0
..\DataSets\DelayGraph_2059.graphml,78,83,161,0.0,18,8
..\DataSets\DelayGraph_2060.graphml,25,24,49,0.0,5,1
..\DataSets\DelayGraph_2061.graphml,37,37,74,0.0,5,1
..\DataSets\DelayGraph_2062.graphml,106,109,215,0.0,10,0
..\DataSets\DelayGraph_2065.graphml,181,212,393,0.0,169,13
..\DataSets\DelayGraph_2067.graphml,106,109,215,0.0,10,0
..\DataSets\DelayGraph_2068.graphml,111,118,229,0.0,18,7
..\DataSets\DelayGraph_2069.graphml,111,118,229,0.0,18,7
..\DataSets\DelayGraph_2070.graphml,146,164,310,0.0,38,6
..\DataSets\DelayGraph_2071.graphml,146,164,310,0.0,38,6
..\DataSets\DelayGraph_2072.graphml,146,164,310,0.0,38,6
..\DataSets\DelayGraph_2073.graphml,72,75,147,0.0,18,0
..\DataSets\DelayGraph_2074.graphml,72,75,147,0.0,18,0
..\DataSets\DelayGraph_2075.graphml,111,122,233,0.0,20,13
..\DataSets\DelayGraph_2076.graphml,128,142,270,0.0,27,12
..\DataSets\DelayGraph_2077.graphml,111,122,233,0.0,20,13
..\DataSets\DelayGraph_2078.graphml,84,91,175,0.0,17,4
..\DataSets\DelayGraph_2079.graphml,84,91,175,0.0,17,4
..\DataSets\DelayGraph_2080.graphml,84,91,175,0.0,17,4
..\DataSets\DelayGraph_2081.graphml,122,126,248,0.0,9,10
..\DataSets\DelayGraph_2083.graphml,61,69,130,0.0,11,6
..\DataSets\DelayGraph_2087.graphml,122,126,248,0.0,9,10
..\DataSets\DelayGraph_2091.graphml,117,137,254,0.0,150,5
..\DataSets\DelayGraph_2097.graphml,63,71,134,0.0,11,6
..\DataSets\DelayGraph_2099.graphml,74,83,157,0.0,14,6
..\DataSets\DelayGraph_2100.graphml,174,244,418,0.0,958,0
..\DataSets\DelayGraph_2101.graphml,174,244,418,0.0,958,0
..\DataSets\DelayGraph_2102.graphml,75,74,149,0.0,13,0
..\DataSets\DelayGraph_2103.graphml,75,74,149,0.0,13,0
..\DataSets\DelayGraph_2104.graphml,6,5,11,0.0,1,0
..\DataSets\DelayGraph_2105.graphml,6,5,11,0.0,1,0
..\DataSets\DelayGraph_2106.graphml,101,99,200,0.0,4,0
..\DataSets\DelayGraph_2107.graphml,101,99,200,0.0,4,0
..\DataSets\DelayGraph_2108.graphml,39,36,75,0.0,8,0
..\DataSets\DelayGraph_2109.graphml,39,36,75,0.0,8,0
..\DataSets\DelayGraph_2110.graphml,112,121,233,0.0,30,14
..\DataSets\DelayGraph_2113.graphml,204,214,418,0.0,48,6
..\DataSets\DelayGraph_2116.graphml,244,269,513,0.0,84,11
..\DataSets\DelayGraph_2117.graphml,534,601,1135,0.0,300,0
..\DataSets\DelayGraph_2118.graphml,181,212,393,0.0,169,13
..\DataSets\DelayGraph_2123.graphml,135,159,294,0.0,53,11
..\DataSets\DelayGraph_2128.graphml,134,157,291,0.0,53,11
..\DataSets\DelayGraph_2131.graphml,180,210,390,0.0,169,13
..\DataSets\DelayGraph_2134.graphml,534,601,1135,0.0,300,0
..\DataSets\DelayGraph_2135.graphml,252,259,511,0.0,52,10
..\DataSets\DelayGraph_2136.graphml,224,267,491,0.0,105,0
..\DataSets\DelayGraph_2137.graphml,224,267,491,0.0,105,0
..\DataSets\DelayGraph_2138.graphml,334,341,675,0.0,80,7
..\DataSets\DelayGraph_2139.graphml,334,341,675,0.0,80,7
..\DataSets\DelayGraph_2140.graphml,585,623,1208,0.0,517,43
..\DataSets\DelayGraph_2143.graphml,166,169,335,0.0,29,4
..\DataSets\DelayGraph_2144.graphml,203,219,422,0.0,47,0
..\DataSets\DelayGraph_2145.graphml,203,219,422,0.0,47,0
..\DataSets\DelayGraph_2146.graphml,55,53,108,0.0,13,0
..\DataSets\DelayGraph_2147.graphml,55,53,108,0.0,13,0
..\DataSets\DelayGraph_2148.graphml,55,53,108,0.0,13,0
..\DataSets\DelayGraph_2149.graphml,105,109,214,0.0,23,0
..\DataSets\DelayGraph_2150.graphml,105,109,214,0.0,23,0
..\DataSets\DelayGraph_2151.graphml,105,109,214,0.0,23,0
..\DataSets\DelayGraph_2152.graphml,248,267,515,0.0,57,9
..\DataSets\DelayGraph_2153.graphml,293,357,650,0.0,155,0
..\DataSets\DelayGraph_2154.graphml,293,357,650,0.0,155,0
..\DataSets\DelayGraph_2155.graphml,14,13,27,0.0,3,0
..\DataSets\DelayGraph_2156.graphml,24,23,47,0.0,5,0
..\DataSets\DelayGraph_2157.graphml,24,23,47,0.0,5,0
..\DataSets\DelayGraph_2158.graphml,212,228,440,0.0,37,0
..\DataSets\DelayGraph_2159.graphml,23,22,45,0.0,4,1
..\DataSets\DelayGraph_2160.graphml,42,44,86,0.0,8,0
..\DataSets\DelayGraph_2161.graphml,42,44,86,0.0,8,0
..\DataSets\DelayGraph_2162.graphml,12,12,24,0.0,4,0
..\DataSets\DelayGraph_2163.graphml,68,68,136,0.0,10,0
..\DataSets\DelayGraph_2164.graphml,161,164,325,0.0,22,5
..\DataSets\DelayGraph_2165.graphml,39,38,77,0.0,8,2
..\DataSets\DelayGraph_2166.graphml,39,38,77,0.0,8,2
..\DataSets\DelayGraph_2167.graphml,71,77,148,0.0,11,8
..\DataSets\DelayGraph_2168.graphml,71,77,148,0.0,11,8
..\DataSets\DelayGraph_2172.graphml,122,131,253,0.0,20,6
..\DataSets\DelayGraph_2175.graphml,19,19,38,0.0,6,0
..\DataSets\DelayGraph_2176.graphml,13,13,26,0.0,4,0
..\DataSets\DelayGraph_2177.graphml,30,28,58,0.0,5,0
..\DataSets\DelayGraph_2178.graphml,13,13,26,0.0,4,0
..\DataSets\DelayGraph_2179.graphml,18,12,30,0.0,6,0
..\DataSets\DelayGraph_2180.graphml,18,12,30,0.0,6,0
..\DataSets\DelayGraph_2181.graphml,17,16,33,0.0,1,0
..\DataSets\DelayGraph_2184.graphml,181,212,393,0.0,169,13
..\DataSets\DelayGraph_2186.graphml,17,16,33,0.0,1,0
..\DataSets\DelayGraph_2187.graphml,18,17,35,0.0,5,0
..\DataSets\DelayGraph_2188.graphml,18,17,35,0.0,5,0
..\DataSets\DelayGraph_2189.graphml,142,143,285,0.0,16,6
..\DataSets\DelayGraph_2190.graphml,114,132,246,0.0,26,11
..\DataSets\DelayGraph_2194.graphml,142,143,285,0.0,16,6
..\DataSets\DelayGraph_2195.graphml,51,46,97,0.0,7,0
..\DataSets\DelayGraph_2196.graphml,51,46,97,0.0,7,0
..\DataSets\DelayGraph_2197.graphml,28,29,57,0.0,8,0
..\DataSets\DelayGraph_2198.graphml,28,29,57,0.0,8,0
..\DataSets\DelayGraph_2199.graphml,133,134,267,0.0,15,3
..\DataSets\DelayGraph_2200.graphml,1968,2189,4157,0.0,284,0
..\DataSets\DelayGraph_2201.graphml,1968,2189,4157,0.0,284,0
..\DataSets\DelayGraph_2203.graphml,132,141,273,0.0,7,5
..\DataSets\DelayGraph_2204.graphml,132,141,273,0.0,7,5
..\DataSets\DelayGraph_2205.graphml,78,83,161,0.0,18,8
..\DataSets\DelayGraph_2208.graphml,41,40,81,0.0,7,0
..\DataSets\DelayGraph_2209.graphml,10,9,19,0.0,2,0
..\DataSets\DelayGraph_2210.graphml,10,9,19,0.0,2,0
..\DataSets\DelayGraph_2211.graphml,58,62,120,0.0,12,0
..\DataSets\DelayGraph_2212.graphml,58,62,120,0.0,12,0
..\DataSets\DelayGraph_2213.graphml,66,63,129,0.0,12,0
..\DataSets\DelayGraph_2214.graphml,66,63,129,0.0,12,0
..\DataSets\DelayGraph_2215.graphml,16,15,31,0.0,3,0
..\DataSets\DelayGraph_2216.graphml,6,5,11,0.0,1,0
..\DataSets\DelayGraph_2217.graphml,507,554,1061,0.0,131,34
..\DataSets\DelayGraph_2218.graphml,189,219,408,0.0,94,84
..\DataSets\DelayGraph_2219.graphml,192,210,402,0.0,66,0
..\DataSets\DelayGraph_2220.graphml,192,210,402,0.0,66,0
..\DataSets\DelayGraph_2221.graphml,426,460,886,0.0,122,25
..\DataSets\DelayGraph_2222.graphml,426,460,886,0.0,122,25
..\DataSets\DelayGraph_2223.graphml,958,1135,2093,0.0,433,99
..\DataSets\DelayGraph_2224.graphml,958,1135,2093,0.0,433,99
..\DataSets\DelayGraph_2225.graphml,19,17,36,0.0,3,0
..\DataSets\DelayGraph_2226.graphml,31,29,60,0.0,5,0
..\DataSets\DelayGraph_2227.graphml,143,148,291,0.0,17,0
..\DataSets\DelayGraph_2228.graphml,12,11,23,0.0,3,0
..\DataSets\DelayGraph_2229.graphml,12,11,23,0.0,3,0
..\DataSets\DelayGraph_2230.graphml,65,70,135,0.0,16,4
..\DataSets\DelayGraph_2231.graphml,88,94,182,0.0,24,1
..\DataSets\DelayGraph_2234.graphml,133,140,273,0.0,27,16
..\DataSets\DelayGraph_2235.graphml,46,50,96,0.0,11,5
..\DataSets\DelayGraph_2236.graphml,46,50,96,0.0,11,5
..\DataSets\DelayGraph_2237.graphml,209,215,424,0.0,37,6
..\DataSets\DelayGraph_2238.graphml,265,316,581,0.0,127,1
..\DataSets\DelayGraph_2239.graphml,92,94,186,0.0,14,0
..\DataSets\DelayGraph_2240.graphml,55,59,114,0.0,4,3
..\DataSets\DelayGraph_2241.graphml,25,27,52,0.0,4,0
..\DataSets\DelayGraph_2242.graphml,25,27,52,0.0,4,0
..\DataSets\DelayGraph_2243.graphml,38,41,79,0.0,16,0
..\DataSets\DelayGraph_2244.graphml,78,83,161,0.0,8,2
..\DataSets\DelayGraph_2245.graphml,78,83,161,0.0,8,2
..\DataSets\DelayGraph_2247.graphml,25,27,52,0.0,9,0
..\DataSets\DelayGraph_2248.graphml,85,94,179,0.0,17,4
..\DataSets\DelayGraph_2249.graphml,85,94,179,0.0,17,4
..\DataSets\DelayGraph_2250.graphml,55,55,110,0.0,10,0
..\DataSets\DelayGraph_2251.graphml,55,55,110,0.0,10,0
..\DataSets\DelayGraph_2252.graphml,260,276,536,0.0,18,6
..\DataSets\DelayGraph_2253.graphml,260,276,536,0.0,18,6
..\DataSets\DelayGraph_2254.graphml,66,74,140,0.0,25,0
..\DataSets\DelayGraph_2255.graphml,66,74,140,0.0,25,0
..\DataSets\DelayGraph_2256.graphml,66,74,140,0.0,25,0
..\DataSets\DelayGraph_2257.graphml,90,96,186,0.0,24,0
..\DataSets\DelayGraph_2258.graphml,90,96,186,0.0,24,0
..\DataSets\DelayGraph_2259.graphml,706,897,1603,0.0,379,1
..\DataSets\DelayGraph_2261.graphml,706,897,1603,0.0,379,1
..\DataSets\DelayGraph_2262.graphml,122,126,248,0.0,9,10
..\DataSets\DelayGraph_2263.graphml,61,69,130,0.0,11,6
..\DataSets\DelayGraph_2268.graphml,122,126,248,0.0,9,10
..\DataSets\DelayGraph_2269.graphml,41,42,83,0.0,10,0
..\DataSets\DelayGraph_2270.graphml,10,9,19,0.0,2,0
..\DataSets\DelayGraph_2271.graphml,10,9,19,0.0,2,0
..\DataSets\DelayGraph_2272.graphml,190,211,401,0.0,145,4
..\DataSets\DelayGraph_2273.graphml,183,223,406,0.0,61,3
..\DataSets\DelayGraph_2274.graphml,183,223,406,0.0,61,3
..\DataSets\DelayGraph_2275.graphml,183,223,406,0.015599966049194336,61,3
..\DataSets\DelayGraph_2276.graphml,9,9,18,0.0,2,0
..\DataSets\DelayGraph_2277.graphml,78,76,154,0.0,10,2
..\DataSets\DelayGraph_2278.graphml,74,84,158,0.0,16,1
..\DataSets\DelayGraph_2279.graphml,74,84,158,0.0,16,1
..\DataSets\DelayGraph_2280.graphml,74,84,158,0.0,16,1
..\DataSets\DelayGraph_2281.graphml,144,155,299,0.0,14,8
..\DataSets\DelayGraph_2282.graphml,25,25,50,0.0,5,1
..\DataSets\DelayGraph_2283.graphml,46,49,95,0.0,10,0
..\DataSets\DelayGraph_2284.graphml,46,49,95,0.0,10,0
..\DataSets\DelayGraph_2285.graphml,113,125,238,0.0,38,0
..\DataSets\DelayGraph_2286.graphml,113,125,238,0.0,38,0
..\DataSets\DelayGraph_2287.graphml,113,125,238,0.0,38,0
..\DataSets\DelayGraph_2288.graphml,666,726,1392,0.0,256,24
..\DataSets\DelayGraph_2289.graphml,474,598,1072,0.0,455,0
..\DataSets\DelayGraph_2290.graphml,474,598,1072,0.0,455,0
..\DataSets\DelayGraph_2291.graphml,206,221,427,0.0,49,9
..\DataSets\DelayGraph_2292.graphml,254,307,561,0.0,125,0
..\DataSets\DelayGraph_2293.graphml,254,307,561,0.0,125,0
..\DataSets\DelayGraph_2294.graphml,75,74,149,0.0,14,0
..\DataSets\DelayGraph_2295.graphml,75,74,149,0.0,14,0
..\DataSets\DelayGraph_2296.graphml,75,74,149,0.0,14,0
..\DataSets\DelayGraph_2297.graphml,202,208,410,0.0,24,4
..\DataSets\DelayGraph_2298.graphml,583,607,1190,0.0,60,0
..\DataSets\DelayGraph_2302.graphml,149,176,325,0.0,287,5
..\DataSets\DelayGraph_2306.graphml,126,147,273,0.0,274,5
..\DataSets\DelayGraph_2308.graphml,63,71,134,0.0,11,6
..\DataSets\DelayGraph_2311.graphml,583,607,1190,0.0,60,0
..\DataSets\DelayGraph_2312.graphml,28,25,53,0.0,5,0
..\DataSets\DelayGraph_2313.graphml,28,25,53,0.0,5,0
..\DataSets\DelayGraph_2314.graphml,28,25,53,0.0,5,0
..\DataSets\DelayGraph_2315.graphml,35,36,71,0.0,3,8
..\DataSets\DelayGraph_2316.graphml,14,13,27,0.0,3,0
..\DataSets\DelayGraph_2317.graphml,14,13,27,0.0,3,0
..\DataSets\DelayGraph_2318.graphml,163,174,337,0.0,58,0
..\DataSets\DelayGraph_2319.graphml,163,174,337,0.0,58,0
..\DataSets\DelayGraph_2320.graphml,20,21,41,0.0,6,0
..\DataSets\DelayGraph_2321.graphml,20,21,41,0.0,6,0
..\DataSets\DelayGraph_2322.graphml,20,21,41,0.0,6,0
..\DataSets\DelayGraph_2323.graphml,20,21,41,0.0,6,0
..\DataSets\DelayGraph_2324.graphml,4,3,7,0.0,1,0
..\DataSets\DelayGraph_2325.graphml,79,86,165,0.0,12,9
..\DataSets\DelayGraph_2326.graphml,1303,1743,3046,0.0,357,10
..\DataSets\DelayGraph_2329.graphml,42,44,86,0.0,8,0
..\DataSets\DelayGraph_2330.graphml,42,44,86,0.0,8,0
..\DataSets\DelayGraph_2331.graphml,106,105,211,0.0,16,2
..\DataSets\DelayGraph_2332.graphml,90,89,179,0.0,12,2
